; 1000_3_boxes_1
####### 
#     # 
# $ $ # 
## ## ##
 #$ . .#
 #   .@#
 #######

; 1000_3_boxes_2
#######  
#     ###
# #   . #
# #.#*# #
#@$ $ # #
#####   #
    #####

; 1000_3_boxes_3
##########
#     #  #
# $ $    #
##$####  #
 #@  .#  #
 #      .#
 ### .####
   ####   

; 1000_3_boxes_4
##### ####
#   ###  #
#       $#
## ####  #
#     #  #
#  #$  $.#
#  # .+###
########  

