; 0313_orimaze-variations_1
####################
#######            #
##  ### ########## #
#   * $  * * * $ # #
#  ## ##.  #  .#   #
##       #####   # #
# *# # #$  #   # # #
#    . . * * * * # #
##  ### *#####* ## #
## ## #  #   #  ## #
##*## ##*#   #*### #
##  # #  #   #  ## #
##* ### *#####* ## #
## * * * * * *   # #
## # # #   #  $#   #
##    @  #####   # #
####### ####### ## #
#######            #
####################

; 0313_orimaze-variations_2
####################
#######            #
##  ### ########## #
#        * * *   # #
# *## ##.  #  *#   #
##       #####   # #
#  # # #   #  $# # #
#  * * * * * * . # #
##  ### *#####* ## #
## ## #  #   #  ## #
##*## ##*#   #*### #
##  # #  #   #  ## #
##* ### *#####* ## #
## . *   * * * $ # #
##$# # #$  #  .#   #
##    @  #####   # #
####### ####### ## #
#######            #
####################

; 0313_orimaze-variations_3
######################
#######              #
##  ### ######### ## #
#   * $  * * *   $ # #
#  ## ##.  #  *# #.  #
##       #####     # #
# $# # #$  #   # # # #
#  . . . * * * * * # #
##  ### *#####* # *# #
## ## #  #   #  #  # #
##*## ##*#   #*###*# #
##  # #  #   #  #  # #
##* ### *#####* # *# #
## * * * * * * *   # #
## # # #   #   # #$  #
##    @  #####     # #
####### ######### ## #
#######              #
######################

; 0313_orimaze-variations_4
######################
#######              #
##  ### ######### ## #
#  *     * * * $   # #
#  ## ##*  #  .# #*  #
##       #####     # #
#  # # #   #   # #*# #
#  * * * * * * *   # #
##  ### *#####* # *# #
## ## #  #   #  #  # #
##*## ##*#   #*###*# #
##  # #  #   #  #  # #
##* ### *#####* # *# #
## $ *   * * * . * # #
##.# # #   #  $# #   #
##    @  #####     # #
####### ######### ## #
#######              #
######################

; 0313_orimaze-variations_5
####################
#######            #
##  ### ########## #
#        * * *   # #
# $## ##*  #  *#   #
##       #####   # #
# *# # #.  #   # # #
#    * $ * * * * # #
##  ### *#####* ## #
## ## #  #   #  ## #
##*## ##*#   #*### #
## ## #  #   #  ## #
##  ### *#####* ## #
#    * . * * * . # #
# *# # #$  #   # # #
##    @  #####   # #
##*## ##   #  *#   #
##     * * * *   # #
###### ########### #
######             #
####################

; 0313_orimaze-variations_6
#####################
#                   #
# ## ########### ## #
# # * * * * * *   # #
#   # #   #   # #*  #
# #     #####     # #
# #.# #$  #  *# #.# #
# #   . * * *   $ # #
# #* # *#####* # *# #
# #  #  #   #  #  # #
# #*###*#   #*###*# #
# #  #  #   #  #  # #
# #* # *#####* # *# #
# #   $ * * * * . # #
#  $# #.  #   # #$  #
# #  @  #####     # #
# ## ########### ## #
#                   #
#####################

; 0313_orimaze-variations_7
###############################
#                             #
# ## ############ ######## ## #
# # * * * * *  *  * * * *   # #
#   # #   #   ## ##   #  *#   #
# #     #####       #####   # #
# #$# #.  #  .# # #$  #  $# # #
# #   $ * * * $ * . * * * . # #
# #* # *#####* ### *#####* ## #
# #  #  #   #  # #  #   #  ## #
# #*###*#   #*## ##*#   #*### #
# #  #  #   #  # #  #   #  ## #
# #* # *#####* ### *#####* ## #
# #   . * * * . * $ * * * $ # #
#  .# #$  #  $# # #.  #  .#   #
# #  @  #####       #####   # #
# ## ########### ######### ## #
#                             #
###############################

; 0313_orimaze-variations_8
     #################
 #####               #
##  ## ########## ## #
#   *    * * * . $ # #
#  ## ##*  #   # #   #
##       #####@    # #
 # # # #*  #  .# #$# #
 # * *   * * * $ . # #
 #* ### *#####* # *# #
 #  # #  #   #  #  # #
 #*## ##*#   #*###*# #
 #  # #  #   #  #  # #
 #* ### *#####* # *# #
 #   * * * * * *   # #
 #*# # #   #   # #*# #
 #       #####     # #
 #*## ##   #  $# #.  #
 #     * * * * . $ # #
 ##### ########## ## #
     #               #
     #################

; 0313_orimaze-variations_9
######################
#                    #
# ### ########### ## #
# ## $ * * * * .   # #
#   .# #   #  $# #$  #
# ##     #####     # #
# #  # #.  #   # # # #
# #  * $ * * * * * # #
# ##  # *#####* # *# #
# ## ##  #   #  #  # #
# ##*###*#   #*###*# #
# ##  #  #   #  #  # #
# ##* # *#####* # *# #
# ## * . * * * $   # #
# ## # #$  #  .# #*# #
# ##  @  #####     # #
#    # #   #  *# #.  #
# ## * * * * *     # #
# ### ########### ## #
#                    #
######################

; 0313_orimaze-variations_10
######################
#                    #
# ### ########### ## #
# ## .   * * * $ * # #
#   $# #.  #  .# #   #
# ##     #####     # #
# #  # #.  #  .# #$# #
# #  * $ * * * $ . # #
# ##  # *#####* # *# #
# ## ##  #   #  #  # #
# ##*###*#   #*###*# #
# ## ##  #   #  #  # #
# ##  # *#####* # *# #
# #  * . * * * . $ # #
# #  # #$  #  $# #.# #
# ##  @  #####     # #
#   .# #$  #  $# #   #
# ## $   * * * . * # #
# ### ########### ## #
#                    #
######################

; 0313_orimaze-variations_11
######################
#                    #
# ### ########### ## #
# ##   . * * * * $ # #
#   *# #   #   # #.  #
# ##     #####     # #
# # *# #   #  .# #$# #
# #    * * * * $ . # #
# ##  # *#####* # *# #
# ## ##  #   #  #  # #
# ##*###*#   #*###*# #
# ## ##  #   #  #  # #
# ##  # *#####* # *# #
# #      * * *   $ # #
# # *# #*  #  *# # # #
# ##  @  #####     # #
#   .# #*  #  $# #*  #
# ## $   * * * .   # #
# ### ########### ## #
#                    #
######################

; 0313_orimaze-variations_12
      ####              #### 
     ##  ################  ##
     #                    * #
     #  ##################  #
####### #                # ##
#    #  #                # # 
# ## # *################ # # 
# # *   * * * * *  *   # # # 
#   # #*  #   # ## # #*# # # 
# #     #####          # # # 
# #.# #$  #  .# ## # # # # # 
# #   . * *@* $ *  * * # # # 
# #* # *#####* ## ### *# # # 
# #  #  #   #  #  # #  # # # 
# #*###*#   #*## ## ##*# # # 
# #  #  #   #  #  # #  # # # 
# #* # *#####* ## ### *# # # 
# # . $ * * *   *  * * # # # 
# #$# #   #  *# ## # # # # # 
# #     #####          ### ##
#   # #$  #  $# ## # #*  #  #
# # * . * * * . *  *   *    #
# ## ############ #######  ##
#                 #     #### 
###################          

