; 0252_ode_1
#####    #### 
#   ######  # 
# .   $ $.. # 
##.#### ##  # 
 # ###.  $ ## 
 #$#  $$*# #  
 #   ..$ # #  
 #$# .   #*## 
## # .$.  $@# 
# .##### ##$##
#  * . $ $.  #
#  #   ###   #
######## #####

; 0252_ode_2
#####    #### 
#   ######  # 
# .   $ $.. # 
##.#### ##  # 
 # ## .  $ ## 
 #$#  $$$# #  
 #   ..* # #  
 #$# .   #$## 
## # .$. .$@# 
#  ##### ##$##
# .* . $ $.  #
#  #   ###   #
######## #####

; 0252_ode_3
#####    #### 
#   ######  # 
#  .  $ $   # 
## #### ##. # 
 # ## .  $ ## 
 #$# .$$$# #  
 # .   * # #  
 #$# ... #$## 
## #  *.  $@# 
#  ##### ##*##
# .* . $ $ . #
#  #   ###   #
######## #### 

; 0252_ode_4
#####    #### 
#   ######  # 
# .   $ $ . # 
## ####.##  # 
 # ## .  $ ## 
 #$# .$$$# #  
 # .   * # #  
 #$#. .. #$## 
## #  *. .$@# 
#  ##### ##$##
#  * . $ $.  #
#  #   ###   #
######## #####

; 0252_ode_5
#####    #### 
#   ######  # 
# .   $ $   # 
## ####.##. # 
 # ##    * ## 
 #$#  **$# #  
 #    .* # #  
 #$#  .. #$## 
## #  *. .$@# 
#  ##### ##$##
#  * . $ $.  #
#  #   ###   #
######## #### 

; 0252_ode_6
#####    #### 
#   ######  # 
#  .  $ $   # 
## ####.##. # 
 # ## .  * ## 
 #$# .$$$# #  
 #   . * # #  
 #$# ... #$## 
## #  *. .$@# 
# .##### ##$##
#  $ . $ $   #
#  #   ###   #
######## #####

; 0252_ode_7
#####    #### 
#   ######  # 
# .   $ $ . # 
## ####.##  # 
 # ## .  * ## 
 #$#  $$$# #  
 # . . *.# #  
 #$# ... #$## 
## #  *. .$@# 
#  ##### ##$##
#  $ . $ $   #
#  #   ###   #
######## #####

; 0252_ode_8
####    ##### 
#   ######  # 
#     $ $   # 
## ####.##  # 
 # ## ...  ## 
 #$#  ***# #  
 #    .*.# #  
 #$#  ...#$## 
## #  *.  $@# 
#  ##### ##$##
#  $   $ $   #
#  #   ###   #
######## #####

; 0252_ode_9
#####    #### 
#   ######  # 
#     $ $   # 
## ####.##  # 
 # ##....$ ## 
 #$#  ***# #  
 #    .*.# #  
 #$#  ...#$## 
## #  *.  $@# 
#  ##### ##$##
#  $   $ $   #
#  #   ###   #
######## #####

; 0252_ode_10
#####    #### 
#   ######  # 
#     $ $ . # 
## ####.##  # 
 # ## .. * ## 
 #$# .$*$# #  
 # .   * # #  
 #$#  .. #$## 
## #  $   *@# 
# .##### ##$##
#  *   * $ . #
#  #   ###   #
######## #####

