; 0312_orimaze2_1
#################################
#                               #
# ## ########## ############ ## #
# # .   * * * *  *  * * * $   # #
#  $# #*  #   ## ##   #  .# #*  #
# #     #####       #####  @  # #
# #.# #.  #   # # #$  #  $# #*# #
# # $ $ * * * * * . * * * .   # #
# #* # *#####* ### *#####* # *# #
# #  #  #   #  # #  #   #  #  # #
# #*###*#   #*## ##*#   #*###*# #
# #  #  #   #  # #  #   #  #  # #
# #* # *#####* ### *#####* # *# #
# #   . * * * * * $ * * *   * # #
# #.# #$  #   # # #.  #  *# # # #
# #     #####       #####     # #
#  $# #   #  *## ##*  #   # #   #
# # . $ * * *       * * * * * # #
# ## ############ ########## ## #
#                               #
#################################

; 0312_orimaze2_2
#################################
#                               #
# ## ########## ############ ## #
# # $ . * * * .  $  * * * $ . # #
#  .# #$  #   ## ##   #  .# #$  #
# #     #####       #####  @  # #
# #*# #*  #   # # #   #  *# # # #
# #     * * * * * * * * *   * # #
# #* # *#####* ### *#####* # *# #
# #  #  #   #  # #  #   #  #  # #
# #*###*#   #*## ##*#   #*###*# #
# #  #  #   #  # #  #   #  #  # #
# #* # *#####* ### *#####* # *# #
# #   * * * * * * $ * * * .   # #
# #*# #   #   # # #.  #  $# #*# #
# #     #####       #####     # #
#  $# #.  #  *## ##$  #   # #.  #
# # . $ * * *     . * * * * $ # #
# ## ############ ########## ## #
#                               #
#################################

; 0312_orimaze2_3
#################################
#                               #
# ## ########## ############ ## #
# # * * * * * *  *  * * * *   # #
#   # #   #   ## ##   #   # #*  #
# #     #####       #####  @  # #
# # # #*  #   # # #$  #  .# # # #
# #     * * * * * . * * * $ * # #
# #* # *#####* ### *#####* # *# #
# #  #  #   #  # #  #   #  #  # #
# #*###*#   #*## ##*#   #*###*# #
# #  #  #   #  # #  #   #  #  # #
# #* # *#####* ### *#####* # *# #
# #     * * * * * $ * * *   . # #
# #*# #*  #   # # #.  #  *# #$# #
# #     #####       #####     # #
#  *# #   #  *## ##*  #  $# #.  #
# #   * * * *       * * * . $ # #
# ## ############ ########## ## #
#                               #
#################################

