; 0988_boring_1_1
  #####################################################################################################################################################################################################
###@$                                                                                           .                                 .   . . . . . . . . . . . . . . . . . . . . . . . . . . . . . . . . #
# * *$*$*$*$*$*$*$*$*$*$*$*$*$*$*$*$*$*$*$*$*$*$*$*$*$*$*$*$*$*$*$*$*$*$*$*$*$*$*$*$*$*$*$*$*$*$$$*$*$*$*$*$*$*$*$*$*$*$*$*$*$*$*$**$$$$$$$$$$$$$$$$$$$$$$$$$$$$$$$$$$$$$$$$$$$$$$$$$$$$$$$$$$$$$$$$  #
#   .$. . . . . . . . . . . . . . . . . . . . . . . . . . . . . . . . . . . . . . . . . . . .  ... . . . . . . . . . . . . . . . .  .................................................................##
#* * . * * * * * * * * * * * * * * * * * * * * * * * * * * * * * * * * * * * * * * * * * * * * $ * * * * * * * * * * * * * * * * * $ $ $ $ $ $ $ $ $ $ $ $ $ $ $ $ $ $ $ $ $ $ $ $ $ $ $ $ $ $ $ $ $ # 
#  * ################################################################################################################################################################################################# 
######                                                                                                                                                                                                 

