; 0664_compact_chaos_01_1
###########
#@        #
# $.$$.$. #
# .$..$.$ #
# $.$$.$. #
# .$..$.$ #
# $.#$.$. #
# .$$.$.$ #
# $..$.$. #
#         #
###########

; 0664_compact_chaos_01_2
###########
#  .  .  .#
# $.$$.$. #
#..$  $ $ #
# $ $$ $..#
#..$ @$ $ #
# $ #$ $..#
#..$$ $ $ #
# $..$.$. #
#  .. .  .#
###########

; 0664_compact_chaos_01_3
###########
#@ .  .  .#
# $.$$.$. #
#..$  $ $ #
# $ $$ $..#
#..$  $ $ #
# $ #$ $..#
#..$$ $ $ #
# $..$.$. #
#  .. .  .#
###########

; 0664_compact_chaos_01_4
 ##########
## .  .  .#
# $.$$.$. #
#..$  $ $ #
# $ $$ $..#
#..$ @$ $ #
# $ #$ $..#
#..$$ $ $ #
# $..$.$. #
## .. .  .#
 ##########

; 0664_compact_chaos_01_5
###########
#@        #
# $ $$.*. #
#  $  *.* #
# $ $*.*. #
#  $ .*.* #
# $ #*.*. #
#  $$ *.* #
# $  $.*. #
#         #
###########

; 0664_compact_chaos_01_6
###########
#@   *    #
# .$.$.$  #
# $#$.$.$ #
# .$.$.$. #
# $..*..$ #
# .$.$.$. #
# $.$.$#$ #
#  $.$.$. #
#         #
###########

; 0664_compact_chaos_01_7
###########
#@   *    #
#  $.$.$  #
# $#*.*.$ #
#  $.$.$  #
# *..*..* #
#  $.$.$  #
# $.*.*#$ #
#  $.$.$  #
#         #
###########

; 0664_compact_chaos_01_8
###########
#         #
# .$$$.$$ #
# $...$$. #
# .$.$..$ #
# $.$+$.. #
# .$.$.$. #
# $.$.$.$ #
#         #
###########

; 0664_compact_chaos_01_9
 ######### 
##       ##
# .$$$.$$ #
# $...$$. #
# .$.$..$ #
# $.$+$.. #
# .$.$.$. #
# $.$.$.$ #
##       ##
 ######### 

; 0664_compact_chaos_01_10
###########
# .       #
# $.$.$.$ #
#.*$.$.$. #
# $.$+$$$.#
# .$.$.$. #
#.$$$.$$$.#
# $..$.$. #
# .    .  #
###########

; 0664_compact_chaos_01_11
#########  
#       #  
# $.$.$.###
# .$.#.$. #
# $.$+$#$ #
# .$.$.$. #
# $*$.$*$ #
# .#.$.$. #
#         #
###########

; 0664_compact_chaos_01_12
#########  
#       #  
# $$.$.$###
# .$.#.$. #
# $.$+$#$ #
# .$.$..$ #
# $*.$.$. #
# .#$.$*. #
##       ##
 ######### 

; 0664_compact_chaos_01_13
###########
#  . @    #
#.$#$.$.$ #
# .$.$.#. #
# $..$..$ #
#.$$#$.$$ #
# $.$.$.$ #
#   .     #
###########

; 0664_compact_chaos_01_14
###########
#    @    #
# $#$.$.$ #
# .$.*.#. #
# $..*..$ #
# $*#$.*$ #
# $.$.$.$ #
#         #
###########

; 0664_compact_chaos_01_15
###########
#  . @    #
# $#$.$.$ #
# .$.$.#. #
# $$...$$ #
# .$#$.$. #
# $.$.$.$ #
#   .     #
###########

; 0664_compact_chaos_01_16
###########
#    @    #
#.$#$.$.$ #
# .$.$.#. #
# $$...$$.#
# .$#$.$. #
# $.$.$.$ #
#         #
###########

; 0664_compact_chaos_01_17
###########
#  . @    #
# $#$.$.$ #
# .$.$.#. #
##$$...$$ #
# .$#$.$. #
# $.$.$.$ #
#   .     #
###########

; 0664_compact_chaos_01_18
###########
#  . @    #
# $#$.$.$ #
# .$.$.#. #
# $$...$$##
# .$#$.$. #
# $.$.$.$ #
#   .     #
###########

; 0664_compact_chaos_01_19
###########
#  #      #
# $.$.$.$ #
# $$*..$. #
# ...+$.$##
# $.$.$.$ #
# $$.$.$. #
#  #      #
###########

; 0664_compact_chaos_01_20
###########
#  #      #
# $.$.$.$ #
# $$*..$. #
# ....$.$##
# $.$.$+$ #
# $$.$.$. #
#  #      #
###########

; 0664_compact_chaos_01_21
###########
#  #      #
# $.$.$.$ #
# $$$..$. #
# ....$.$##
# $.$.$+$ #
#.$$.$.$. #
#  #      #
###########

