; 0305_template-based_1
  ##### 
###@  # 
#  $# ##
# .*.  #
## $#  #
 ##    #
  ######

; 0305_template-based_2
#####  
#   ## 
#    ##
# #$..#
#@ $$.#
####  #
   ####

; 0305_template-based_3
####     
#  ##### 
#@ #   # 
#    # ##
#.$*$.  #
#  #    #
#########

; 0305_template-based_4
    ####
 ####  #
##  #  #
# .$*$.#
#   @  #
#  #####
####    

; 0305_template-based_5
    #### 
    # @# 
#####  ##
#   $$  #
#  #.$  #
##  ..###
 ##  ##  
  ####   

; 0305_template-based_6
   #### 
####  # 
#@ #  # 
#.$*$.##
#  #   #
##   # #
 # ### #
 #     #
 #######

; 0305_template-based_7
 #######
 #  #  #
##  #  #
# .**$ #
#   #@##
###    #
  ##   #
   #####

; 0305_template-based_8
  ####
  #  #
###$.#
#  $.#
# #$.#
# #@ #
# #  #
#    #
######

; 0305_template-based_9
#####     
#   ###   
#   . #   
### $ #   
  ##* ####
  # $    #
  #@.#   #
  #  #####
  ####    

; 0305_template-based_10
 #####
 #   #
 #   #
 # . #
 # * #
## *##
#  $@#
#   ##
#  ## 
####  

; 0305_template-based_11
    #####
#####   #
#  @$.# #
#  #.$  #
##  $. ##
#  ##  # 
#    ### 
##   #   
 #####   

; 0305_template-based_12
  #####
  #   #
 ## # #
 #    #
##$*###
# *.## 
# #  # 
#@   # 
#    # 
###### 

; 0305_template-based_13
######  
#  @ ## 
#  $$ # 
###$ .##
 #  .. #
 #  #  #
 ####  #
    ####

; 0305_template-based_14
    ####
#####  #
# @ #  #
# .$*$.#
### #  #
  #   ##
  # # # 
  #   # 
  ##### 

; 0305_template-based_15
    #####
  ###   #
 ##.# # #
 # $@   #
## *## ##
#  $    #
#  .#   #
#####  ##
    #### 

; 0305_template-based_16
  ###    
 ##.###  
 # $@ ###
## *#   #
#  $    #
#  .# # #
#####   #
    #####

