; 0614_90_000_moves_only_1
######################   ######################
# . . . . . . . . .  #####  #  #  #  #  #  #  #
#  $ $ $ $ $ $ $ $ $ #     .#$   .#$   .#$   .#
## ################### # #$ # .#$ # .#$ # .#$ #
#  . . . . . . . . . # # # .#$ # .#$ # .#$ # .#
# $ $ $ $ $ $ $ $ $  # # #$ # .#$ # .#$ # .#$ #
################### ## # # .#$ # .#$ # .#$ # .#
# . . . . . . . . .  # # #$ # .#$ # .#$ # .#$ #
#  $ $ $ $ $ $ $ $ $ # # # .#$ # .#$ # .#$ # .#
## ################### # #$ # .#$ # .#$ # .#$ #
#  . . . . . . . . . # # # .#$ # .#$ # .#$ # .#
# $ $ $ $ $ $ $ $ $  # # #$ # .#$ # .#$ # .#$ #
################### ## # # .#$ # .#$ # .#$ # .#
# . . . . . . . . .  # # #$ # .#$ # .#$ # .#$ #
#  $ $ $ $ $ $ $ $ $ # # # .#$ # .#$ # .#$ # .#
## ################### # #$ # .#$ # .#$ # .#$ #
#  . . . . . . . . . # # # .#$ # .#$ # .#$ # .#
# $ $ $ $ $ $ $ $ $  # # #$ # .#$ # .#$ # .#$ #
################### ## # # .#$ # .#$ # .#$ # .#
# . . . . . . . . .  # # #$   .#$   .#$   .#$ #
#  $ $ $ $ $ $ $ $ $ # # #  #  #  #  #  #  #  #
## ################### @ ################### ##
#  #  #  #  #  #  #  # # # $ $ $ $ $ $ $ $ $  #
# $#.   $#.   $#.   $# # #  . . . . . . . . . #
#. # $#. # $#. # $#. # # ## ###################
# $#. # $#. # $#. # $# # #  $ $ $ $ $ $ $ $ $ #
#. # $#. # $#. # $#. # # # . . . . . . . . .  #
# $#. # $#. # $#. # $# # ################### ##
#. # $#. # $#. # $#. # # # $ $ $ $ $ $ $ $ $  #
# $#. # $#. # $#. # $# # #  . . . . . . . . . #
#. # $#. # $#. # $#. # # ## ###################
# $#. # $#. # $#. # $# # #  $ $ $ $ $ $ $ $ $ #
#. # $#. # $#. # $#. # # # . . . . . . . . .  #
# $#. # $#. # $#. # $# # ################### ##
#. # $#. # $#. # $#. # # # $ $ $ $ $ $ $ $ $  #
# $#. # $#. # $#. # $# # #  . . . . . . . . . #
#. # $#. # $#. # $#. # # ## ###################
# $#. # $#. # $#. # $# # #  $ $ $ $ $ $ $ $ $ #
#. # $#. # $#. # $#. # # # . . . . . . . . .  #
# $#. # $#. # $#. # $# # ################### ##
#.   $#.   $#.   $#.     # $ $ $ $ $ $ $ $ $  #
#  #  #  #  #  #  #  #####  . . . . . . . . . #
######################   ######################

; 0614_90_000_moves_only_2
######                              
#    #######                        
# $$       #########################
#  $ $ $ $                         #
# $$ $ $ $ $ $ $ $ $ $ $ $ $ $ $ $ #
#  $ $ $ $ $ $ $ $ $ $ $ $ $ $ $ $ #
#### $ $ $ $ $ $ $ $ $ $ $ $ $ $ $ #
#  # $ $ $ $ $ $ $ $ $ $ $ $ $ $ $ #
#    $ $ $ $ $ $ $ $ $ $ $ $ $ $ $ #
#  # $$$$$$$$$$$$$$$$$$$ $ $ $ $ $ #
## #     $ $ $ $ $ $ $ $ $ $ $ $ $ #
 # #####                  ######## #
 # #   ####################  #   # #
 # #                         #   # #
 # ## #####################  #   # #
 #  # #...................# ##   # #
 #  # #...................# #    # #
 #  # #...................# #    # #
## ## #...................# #    # #
#     #...................# #    # #
#   # #  .................# #    # #
#####  ...................@ $    # #
#   # #  .................# #    # #
#     #...................# #    # #
## ## #...................# #    # #
 #  # #...................# #    # #
 #  # #...................# #    # #
 #  # #...................# ##   # #
 # ## #####################  #   # #
 # #                         #   # #
 # #   ####################  #   # #
 # #####                  ######## #
## #     $ $ $ $ $ $ $ $ $ $ $ $ $ #
#  # $$$$$$$$$$$$$$$$$$$ $ $ $ $ $ #
#    $ $ $ $ $ $ $ $ $ $ $ $ $ $ $ #
#  # $ $ $ $ $ $ $ $ $ $ $ $ $ $ $ #
#### $ $ $ $ $ $ $ $ $ $ $ $ $ $ $ #
#  $ $ $ $ $ $ $ $ $ $ $ $ $ $ $ $ #
# $$ $ $ $ $ $ $ $ $ $ $ $ $ $ $ $ #
#  $ $ $ $                         #
# $$       #########################
#    #######                        
######                              

; 0614_90_000_moves_only_3
     ####                             #####
     #  ###############################   #
     #                                    #
 #####  ############ ##################  ##
 #    # #   #  #   #####  ##  ##  ##  #  # 
 #    # #      #     ................ #  # 
 # # ## ## ##  ## ## #.#.#.#.#.#.#.#. #  # 
 # # #     ## ###  # ................ #  # 
 # # #     #       # #.#.#.#.#.#.#.#. #  # 
 # # #######   ##  # ................ #  # 
 # #   @   ######### #.#.#.#.#.#.#.#. #  # 
 # #  $ $ $#       # ................ #  # 
 # # $ $ $ #       # #.#.#.#.#.#.#.#. #  # 
 # #  $ $ $#       # ................ #  # 
 # # $ $ $ #       # #.#.#.#.#.#.#.#. #  # 
 # #  $ $ $#         ................ #  ##
 # # $ $ $ #      ##   #   ##  ##  #  #  ##
 # #  $ $ $########################## #  ##
 # # $ $ $ $ $ $ $ $ $ $ $ $ $ $ $ $  ## ##
 # #  $ $ $ $ $ $ $ $ $ $ $ $ $ $ $ $  # # 
 # # $ $ $ $ $ $ $ $ $ $ $ $ $ $ $ $ $ # # 
 # #  $ $ $ $ $ $ $ $ $ $ $ $ $ $ $ $  # # 
 # # $ $ $ $ $ $ $ $ $ $ $ $ $ $ $ $ $ # # 
 # #  $ $ $ $ $ $ $ $ $ $ $ $ $ $ $ $  # # 
 # # $ $ $ $ $ $ $ $ $ $ $ $ $ $ $ $ $ # # 
 # #                                   # ##
## #####################################  #
#                                         #
#   ####################################  #
#####                                  ####

