; 0055_blazz_01_1
#####    
# @ #    
#   #####
# $  $  #
###$$## #
 #  ..  #
 #  ..###
 ######  

; 0055_blazz_01_2
  ############  
  #     #    ###
### # # #..... #
# $$$$$ @    # #
# # # # ###  # #
# #     ###### #
# #######      #
#         ######
###########     

; 0055_blazz_01_3
   #####   
  ##   ### 
### $#   # 
#    . $ # 
# #.#*#.###
# #  *  $@#
#   ## ## #
######    #
     ######

; 0055_blazz_01_4
   ##### 
 ### @ ##
 #   #  #
 # #.$. #
## #$*$ #
#   .$. #
# # #####
#   #    
#####    

; 0055_blazz_01_5
########
#      #
# #$.#@#
# $. . #
##$#.$##
 # #  # 
 #   ## 
 #####  

; 0055_blazz_01_6
    ####  
   ##  #  
   #   #  
 ###   #  
##  $#$## 
#  #@$  # 
# # $ $ # 
#...#$# ##
#   .*.. #
##  ##   #
 #########

; 0055_blazz_01_7
   #####   
   # . #   
   #$.$#   
#### . ####
# $ $ $ $ #
#... @ ...#
# $ $ $ $ #
#### . ####
   #$.$#   
   # . #   
   #####   

; 0055_blazz_01_8
#########
#   ## @#
#    $  #
##$  ##$#
## #$. .#
# $  .#.#
#   #.  #
#########

; 0055_blazz_01_9
 #######  
 #  #@ ###
## $#$ $ #
#.  #  $ #
#..* $   #
#..# $ $ #
#. . #####
######    

; 0055_blazz_01_10
########  
#      #  
# #$##$#  
# #..  #  
# #..# #  
#  ..# ###
####$#   #
# $ $ $  #
#   @ ####
#  ####   
####      

; 0055_blazz_01_11
###########
# .  #    #
# *$$#$.  #
#@.   $. ##
# *$$#$. # 
# .  # . # 
########## 

; 0055_blazz_01_12
     #####   
 #####   #   
 # $     #   
 # #$##$#####
##@  .. ..  #
#  ######$$ #
# $$ $ $ $  #
#  # .. ....#
#############

; 0055_blazz_01_13
  #######  
  #     ###
### # #   #
#@$$$$$   #
#     ## ##
######## ##
#         #
# $$ $    #
###  ######
# $ $ $ #  
#.....# #  
#.#*#*# #  
#.....  #  
#########  

; 0055_blazz_01_14
    ####    
    #  #### 
##### $   # 
#   #  ##$##
# @ ..*##  #
## #.#.##$ #
 # #.#.##  #
 # $... #$ #
 # $ $  #  #
 # ######$ #
 # $       #
 #   #######
 #####      

; 0055_blazz_01_15
         #####
 #########   #
 #   ..... # #
 # ##.#$##$  #
##$##.*...  ##
# $ $ #  # ## 
#   @ $  # ## 
##$###$###  # 
#     $   $ # 
#   ######  # 
#####    #### 

; 0055_blazz_01_16
       #####   
 #######   #   
 #       # #   
##@###$$$$ #   
#   ## $ $##   
# # $  #...#   
#  $$$ #..#####
##  #  #..... #
 #### ####### #
    #         #
    ###########

; 0055_blazz_01_17
     #########
   ###  #    #
   # $ $# $# #
  ##   $   # #
###. ### $ $ #
# ...$@#   # #
# #. #$###$  #
#   #..    ###
#    ..  ###  
##### # ##    
    #   #     
    #####     

; 0055_blazz_01_18
      ######  
     ##    #  
######@ ##$###
#   # .# $ $ #
# $  ...     #
## ## .$ #$###
 # ##$.### #  
 # ## . ## ## 
 # ###.$##  # 
 #$   .     # 
 #  ######### 
 ####         

