; 0464_rebus_1_1
###########
#   #  #  #
#    * $  #
##$#*# #. #
##  .. #  #
#*@#$* *$##
## #. .   #
# *# ###$*#
#    $ .  #
#  *###   #
###########

; 0464_rebus_1_2
######################
##  *.#     ##   #   #
##$....* # $## $$$$$ #
## .#.#. #  @#   #   #
## #   $ # #$#       #
#  $$#   #  . .##.#* #
# $$ $ ### # # ...*. #
# $  # ### #$# $ . *##
####   ##    # # ## ##
#.. #####$$ ##########
##    $   $ ##*##*####
##  .  . .###*##*#*#*#
######################

; 0464_rebus_1_3
##################
###    ###     # #
## *.*$ ###* $ * #
## .$.  ##  *.*  #
#  .*$* ##  *@*  #
# $$* $    $*.*  #
###  . ##    $  ##
#*# $. #   #   ###
###..* #  $###$###
#*# $#*#     $  .#
###   ###    .  ##
#*#########.##.###
##################

; 0464_rebus_1_4
####################
###  ##*#*######*###
##*  *######   ###*#
#*    * ###  $  #  #
##  $*. *   # *   .#
#### ..$  #  $ $* $#
#*###* $ ### *$  @ #
##*###  ####$.  *$ #
####*#*###* .#*#* *#
#*######### . * *  #
###*#*#*#*# . .  .##
####################

; 0464_rebus_1_5
#####################
#                   #
# ############## *# #
# #   * * * * . $ # #
#  .# #   #  $* #.  #
# *     ##*##     * #
# *.# #$  #  *# #*# #
# # $ . * * *     # #
# #* # *##$##* # *# #
# #  #  #  .#  #  # #
# #**##*  # $*###*# #
# # @#  #. .#  #  # #
# #* # *##$##* # *# #
# # . * * * * $   # #
# #$# #   #  .# *$* #
# #     #####     * #
#  $# #.  #   * #   #
# # . $ * * * * * # #
# #* ########### ## #
#                   #
#####################

; 0464_rebus_1_6
################
####*   .   ####
###** $#.#$ ####
##     *.*    ##
## #*#*#.#*#* ##
##@*   $.   * ##
###$*$    $*$###
## *    *   * ##
## #*#*#.#*#* ##
##     *.*    ##
##*## $#.#$ *###
#####   .   *###
################

; 0464_rebus_1_7
#####################
# #*#*#*#*#*#*#*#*# #
###               ###
#* ..*.*.*+*.*.*.. ##
## .* * * * * * *. *#
#* * $ $ $ $ $ $ * ##
## .* $ $ * $ $ *. *#
#* * $ * * * * $ * *#
## .* $ * * * $ *. ##
#* * $ * * * * $ * *#
## .* * * * * * *. ##
#* * $ * * * * $ * *#
#* .* $ * * * $ *. ##
## * $ * * * * $ * *#
## .* $ $ * $ $ *. ##
#* * $ $ $ $ $ $ * *#
## .  * * * * * *. ##
#* ..*.*.*.*.*.*.. *#
##*               *##
###*#*#*#*#*#*#*#*###
#####################

; 0464_rebus_1_8
###############  
# # # # # # # ###
################ 
 # $ .   $ .   ##
##   # # # #$  # 
 #* **. . *.. *##
##   #$ . $#   # 
 # $ * .*. * $ ##
##*$$#*.#.#* $*# 
 # $ **.***# $ ##
##@  #  #  *   # 
 #* *** * *#* *##
##   # # # *   # 
 # $ .     . $ ##
################ 
# # # # # # # # #

; 0464_rebus_1_9
###########
#*#*#  #  #
#   **..  #
#   .*.#  #
##$*#***$##
#  $   * *#
#  $*#@#  #
#*#       #
##*   #*  #
###########

; 0464_rebus_1_10
#################
## *     @  #####
#  ...$$#$   #*##
## $$...#. $#. ##
#   $ $ #* *.  ##
##*  *# # * #$ ##
# ####  #.  $ .##
##. $  ## *# $ ##
#  $$.$ #    #*##
##  .  .#########
#################

; 0464_rebus_1_11
###################################
#@                                #
# #* #**#**#***# #*#*#**#*#*#* *# #
# * * $ * * * *     . * * * . $ * #
#   # *.  *   **# #**$  *  $* #.  #
# *     *#**#         #*#*#     * #
# # * #$  *   # **# #*  *  .# **# #
# * * . * * * * .*.   * * * $   * #
# #* # ***$#** *$ $# ***$*** # *# #
# *  *  #. .*  # $ *  #  .#  *  * #
# #*****$ *  ***.  ***$ *  *#***# #
# *  *  #.  *  #$ $*  #. .#  *  * #
# #* # ***$#** *  .# ***$*** # *# #
# *   . * * * *  *. * * * * $   * #
# #** #$  *   #.#** #   #  .# #*# #
# * #   *#*#*    $    #***#   * * #
# # * *.$   $.*  .# #  $ $ .* #   #
# *   #*   $ *# .$. **  *  *#   # #
#   # *.$ $ ..$$$*$$#..$ $ .* # * #
# * *   #***# .  $  . *#*#*   * # #
# #*# #.  *   # *#*.#*  *  *# #$* #
# * . $ * * * * .*    * * *   . # #
# #* # *#* *#* #.$ * **#$*** # ** #
# *  *  *.  *  *$ $#  *. .#  *  # #
# #***#*$ # $**# . ***$ # $*#**** #
# *  *  *. .#  *   #  #.  *  *  # #
# #* # **#$*** #$ $* *** #** # ** #
# * . $ * * *   .*.   * * *     # #
# #$# #.  #  *# *#* #*  #  $# #** #
# *     #.**#         #****     # #
#  .# #$ $#   #*# #**.  #   # #*  #
# * $ * . . * *     $ * * * *   * #
# #* #*#*#*#*#*#*# #*#*#*#*#*# *# #
#                                 #
###################################

; 0464_rebus_1_12
################### 
##..  ...  ..##   ##
#...  ...  ...#.#$##
#  #*##$*#*#       #
# $ $   $   $ #  $.#
# $  $ # $ $$ # $$ #
#$$$     $  $ #.. ##
#  ##*#$##*#  #  $##
##           ##.  # 
########## ######## 
#                 ##
#  $$$ $$ **..$ $ ##
#*#*..$..**.$.#.**##
#.*.**#.*.#*$****.##
# #$  #$$$$.*.* $$# 
#@            .   ##
####################

; 0464_rebus_1_13
#################
#**#*## .###  ###
# $     $$   $*##
#   $ *# #**  *##
## #*   $  #$ ###
## *  #**#    *##
##$* #*..** # *##
#.$ $*..*.# *  ##
#  # *..+.    *##
## * #*..*# # ###
##    # #*  * *##
#* $# $    *# ###
#*  **# *# #   ##
##$   $        *#
##  ###. **###**#
#################

; 0464_rebus_1_14
#############
#**######**##
#*.*   #    #
## * #   #  #
## # ##*#  *#
## * *   *# #
## *#  #* * #
## $ # $ .# #
##.# *  # * #
#* @* # *   #
## $# .*$ # #
#*  * # #   #
###**     ###
#############

; 0464_rebus_1_15
################################
###@            ##.....       .#
# $**#*****#*#. ####### $.$.$  #
# *     *     * #############$ #
# *  *  *# *  * ##. .$ $.   #  #
# # * * * .$$ * #.#$## ##.# #$ #
# $  *  *  *  #   $   *   * # .#
# *     *     * #.#  * *$ #.#$ #
# *#****.**#*#*   #$* #$. #$$  #
# *     #     * #$ . . * *  #$ #
# # . . * $ . *   # *$. . #$#  #
# * $$  * . $#* #$#  .$*$ #.#$ #
# *   $#*#    * #.$ $ .   $ #  #
# *     *     * * # ## ##$#.#$.#
# .*#******#*#. #   .$ $. .##  #
#                  #     #    ##
################################

; 0464_rebus_1_16
#################################
#                               #
# #* *#*#*#*#*# #*#*#*#*#*#* ** #
# *   $ * * * *   . * * * * * # #
#  *# #   #   *# #*$  #   # #   #
# #     #***#       #***#     # #
# **# #   #  $# # #   #  *# #.* #
# #   * * * * . * * * * *   $ # #
# ** # **#$#** # #  *#$#** * ** #
# #  *  #  .#@ * *  #. .#  #  # #
# ******$ *  *#***#*$ * $****** #
# #  *  #. .#  * *  #.  #  #  # #
# ** # **#$#** # #  *# #** * ** #
# # .   * * * * * $ * * * $ . # #
# * # #*  *   # # #.  *  .# #$* #
# #     #**#*       *#**#     # #
#   # #   *  .#* #**  *  $# #   #
# # * * * * * $     * * * . * # #
# ** *#*#*#*#*#* *#*#*#*#*#* ** #
#                               #
#################################

