; 0470_essai_1
      #######      
  #####  ...#      
  #   #  # ##      
 ##$ $#@$# ########
## $  #$ $   $ $  #
#  $    $  $      #
#     #    #  #####
# $  $###### .....#
####  #    # .....#
   ####    ########

; 0470_essai_2
######             
#   @#      ###### 
# $$$#      #    # 
#  $ ########$   # 
##$  #       $   # 
 #   #  ##### #### 
 #     $##### #    
 #####$ $     #    
     #     $  #    
  #### ###### #####
  #..... . .      #
  #.... ##        #
  #################

; 0470_essai_3
         #         
        ###        
       ## ##       
     ### @ ###     
     #  $ $  #     
    ## $ $ $ ##    
   ## $ $ $ $ ##   
  ##   $ $ $   ##  
 ##  #  # #  #  ## 
 #       $       # 
######### #########
       # ..#       
       # ..#       
     ### ..###     
     #.......#     
     #########     

; 0470_essai_4
      #########     
    ###...$.. ##    
   ##....*.*...##   
######  ## # #####  
#       #     $  ###
# $ $   $   $ $   @#
####$ $ $ $ $ #$ ###
  ##  #########  ## 
   ####       ####  
    ##         ##   

; 0470_essai_5
  ####  
  # @#  
  #$ #  
  #  #  
  #$ #  
 ##  ## 
##  $ ##
## $. ##
#  ##  #
#  .. ##
# $##  #
## ..$ #
#  ##$ #
#  .. ##
# $##  #
# $.*  #
#  #.  #
########

; 0470_essai_6
          #          
          #          
          #          
         ###         
        ##.##        
       #@#.# #       
      #  #.#  #      
  #  # $ #.# $ #  #  
  # # $ $ .#  $ # #  
  ## $  $ . $  $ ##  
  # $  $$#.#$$  $ #  
 #.      #.#      .# 
##########.##########
  #      #.#      #  
         #.#         
       ###.###       
     #####.#####     
         ###         
          #          

; 0470_essai_7
     ########       
    #. . .   #     #
   # ######$ ##   ##
  # .$    $ ##@###.#
 # $ $$    $   #  .#
#  $$ ##### $$$ ...#
 #      $  $  #$...#
  #  $  $ $  ##.##.#
   # #######  ##  ##
    #. . . .  #    #
     #########      

