; 0900_xibo_1
###########
#         #
# ####### #
# ###     #
# ###.### #
# # . $ . #
# # #$*$# #
#   . *   #
# #$*$*$**#
# . . *   #
######## @#
       ####

; 0900_xibo_2
###########
#         #
# ####### #
# ###     #
# ###.### #
# # . $ . #
# # #$*$# #
# # # * # #
#   . *   #
# #$*$*$**#
# . . *   #
######## @#
       ####

; 0900_xibo_3
###########
#         #
# ####### #
# ###     #
# ###.### #
# # . $ . #
# # #$*$# #
# # # * # #
# # # * # #
#   . *   #
# #$*$*$**#
# . . *   #
######## @#
       ####

; 0900_xibo_4
###########
#         #
# ####### #
# ###     #
# ###.### #
# # . $ . #
# # #$*$# #
# # # * # #
# # # * # #
# # # * # #
#   . *   #
# #$*$*$**#
# . . *   #
######## @#
       ####

; 0900_xibo_5
###########
#         #
# ####### #
# ###     #
# ###.### #
# # . $ . #
# # #$*$# #
# # # * # #
# # # * # #
# # # * # #
# # # * # #
#   . *   #
# #$*$*$**#
# . . *   #
######## @#
       ####

; 0900_xibo_6
###########
#         #
# ####### #
# ###     #
# ###.### #
# # . $ . #
# # #$*$# #
# # # * # #
# # # * # #
# # # * # #
# # # * # #
# # # * # #
#   . *   #
# #$*$*$**#
# . . *   #
######## @#
       ####

; 0900_xibo_7
###########
#         #
# ####### #
# ###     #
# ###.### #
# # . $ . #
# # #$*$# #
# # # * # #
# # # * # #
# # # * # #
# # # * # #
# # # * # #
# # # * # #
#   . *   #
# #$*$*$**#
# . . *   #
######## @#
       ####

; 0900_xibo_8
###########
#         #
# ####### #
# ###     #
# ###.### #
# # . $ . #
# # #$*$# #
# # # * # #
# # # * # #
# # # * # #
# # # * # #
# # # * # #
# # # * # #
# # # * # #
#   . *   #
# #$*$*$**#
# . . *   #
######## @#
       ####

; 0900_xibo_9
###########
#         #
# ####### #
# ###     #
# ###.### #
# # . $ . #
# # #$*$# #
# # # * # #
# # # * # #
# # # * # #
# # # * # #
# # # * # #
# # # * # #
# # # * # #
# # # * # #
#   . *   #
# #$*$*$**#
# . . *   #
######## @#
       ####

; 0900_xibo_10
###########
#         #
# ####### #
# ###     #
# ###.### #
# # . $ . #
# # #$*$# #
# # # * # #
# # # * # #
# # # * # #
# # # * # #
# # # * # #
# # # * # #
# # # * # #
# # # * # #
# # # * # #
#   . *   #
# #$*$*$**#
# . . *   #
######## @#
       ####

; 0900_xibo_11
###########
#         #
# ####### #
# ###     #
# ###.### #
# # . $ . #
# # #$*$# #
# # # * # #
# # # * # #
# # # * # #
# # # * # #
# # # * # #
# # # * # #
# # # * # #
# # # * # #
# # # * # #
# # # * # #
#   . *   #
# #$*$*$**#
# . . *   #
######## @#
       ####

; 0900_xibo_12
###########
#         #
# ####### #
# ###     #
# ###.### #
# # . $ . #
# # #$*$# #
# # # * # #
# # # * # #
# # # * # #
# # # * # #
# # # * # #
# # # * # #
# # # * # #
# # # * # #
# # # * # #
# # # * # #
# # # * # #
#   . *   #
# #$*$*$**#
# . . *   #
######## @#
       ####

