; 0721_jw2005_1
      #####   
      #   #   
 ###### # ####
 #@ $ $  $$  #
 #$ # $$# $  #
 # $  $      #
##  $# #####*#
#  $ ###.....#
# $  #  .$...#
## $    .....#
 ####### .####
       ####   

; 0721_jw2005_2
########### 
#   #     # 
# $   $ $ # 
##$#.###  # 
 # #....# # 
 # #... #$# 
## #  @ # ##
#  ###$##  #
#       $$ #
#####      #
    ########

; 0721_jw2005_3
##########
# $ .*.$ #
# $ *..$ #
#   +**  #
# $#**.$ #
# $ .*. ##
# $ ***$ #
# $ *..  #
##########

; 0721_jw2005_4
############ 
#          # 
# ######## # 
# #......# ##
# #  ....#  #
# #    $ @  #
# #  ##### ##
# #### $ $ # 
#   $ $ $  # 
#  $ $ $ $ # 
##      #  # 
 ########### 

; 0721_jw2005_5
############ 
#          ##
# # ######  #
#....... @  #
# # ###### ##
# #  $ $   # 
#     $ $  # 
#  # $ $ $ # 
#########  # 
        #### 

