; 0528_the_first_one_1
 ########## 
 #. .... .# 
 #$##  ##$# 
##        ##
#.  #  #  .#
#    ##    #
##        ##
 # $$$$$$ # 
 #   @    # 
 ########## 

