; 0939_the_best_levels_1
##########
#######  #
###  ##  #
#        #
# #..## *#
#* #.##  #
# $ @## *#
# $$###  #
#       *#
#######  #
##########

