; 0303_other_1
 #####  
 #   #  
 # $@#  
 #   #  
#### ###
#  $ $ #
# ..  .#
########

; 0303_other_2
  ####    
###  #####
#  $  $  #
# ..*...@#
##  $ $$ #
 ####  ###
    ####  

; 0303_other_3
##########
#        #
#@$*.****#
###  #   #
  #      #
  ########

; 0303_other_4
       ##### #### #####
    ####   ###  ###   #
#####      #    ##    #
#  ## #  ###  # ##  ###
#@$## #       # ### ###
## ## # #####         #
#       #  ########   #
#  #### ####  #   # ###
#  ####    #  #####  # 
###        #         # 
  #   ###  ##  ##### # 
####### #########  # # 
#            #  #### # 
##### ####   #     # # 
##  ###  ##### ##  # ##
#              ##     #
#  ##### ###   ## #   #
## ##.    ##   ## # ###
## #####  ###     # #  
#    ##  ###  ####  ###
#    ##    #  #  #    #
###  ###   #  #  ##   #
  #### ########   #####

; 0303_other_5
  ###### 
###.   # 
# @  $ ##
# $# # .#
#   *   #
#. # #$ #
## $    #
 #   .###
 ######  

; 0303_other_6
##########  
#        #  
#  $ # # ###
##$*****.. #
 #    @    #
 ###########

; 0303_other_7
   ####     
 ###  ####  
 #   @.  #  
 #  $ #  ###
##.####$   #
#   # #  $ #
#   ####. ##
##  # $ * # 
 #  .    ## 
 #########  

; 0303_other_8
 ####     
 #  ##### 
 #  *@$ # 
##.## * # 
#  .##$ ##
#        #
######   #
     #####

; 0303_other_9
   ######
####    #
#  .  @##
#  ###*# 
# *### ##
#     * #
##*#$   #
 #    ###
 ######  

; 0303_other_10
  ########    #####   
  #      #  ###   #   
  # $.$*$## # $$. #   
  #  *..  # #  .$*#   
  # #* *  ####  . #   
  #   #####    #  #   
##### ##### ######### 
#       @     ##    ##
# ########### ## .#$ #
# ###      ##   .$ $ #
# #  .#.$$ #### $..# #
# # * * *  #  # #  * #
# # *$. *###  #  #*  #
#      ###    ##    ##
########       ###### 

; 0303_other_11
####    
#  #### 
#@$   ##
# *.*$.#
#    # #
##$ ## #
 #    .#
 #######

; 0303_other_12
########
#  .#  #
# #.$ .#
#    $$#
#####  #
  #   @#
  #    #
  ######

; 0303_other_13
  ####  
###  #  
#@.$ ## 
# $ . ##
# *.$*.#
#  $   #
#  #####
####    

; 0303_other_14
   #### 
####@ ##
# $  $ #
#..  # #
#. #$  #
##  $  #
#.   ###
######  

