; 0955_the_magic_tower_1
#############
#.          #
# ##$#$#### #
#.  *  .* $ #
# $ # #.. # #
# *## #  *  #
#.  *.*$$$# #
# $ # #   # #
# *##   $ # #
# $ ##*## # #
#.$.$.$ # $ #
#...  +  $. #
#############

; 0955_the_magic_tower_2
#############
#+.$       .#
#.$ # $ $ # #
# ##### ### #
# $..#   # *#
# #..$$ $$  #
# # ##   #*.#
# $*.#$ $#.*#
# #..$   $  #
# # ##$ $## #
# $..#   # .#
###..$   $.##
#############

; 0955_the_magic_tower_3
#############
# ...... $ .#
#* $***# $. #
# .#...# ##$#
#$###.#   $ #
#         # #
#*### ## $# #
#  $   $  #.#
#$ $$$$$ $# #
#. #  #   # #
# ### ## #  #
#+$    . $ .#
#############

; 0955_the_magic_tower_4
#############
# .   *   $.#
#. $#$#$#...#
# $.#    #* #
# $ # * . $ #
#.# * $ # $ #
# $  #  ### #
# #  .#   . #
#*# # $ *##$#
#  $### $ # #
# #.  #.*.# #
#  .$   $  +#
#############

; 0955_the_magic_tower_5
#############
#    *    * #
# # $#.#$*# #
# *$    ..$ #
# # $#$#. # #
# .$.#   ## #
# $.$  $    #
# .$.$ ####*#
# ####$#  $ #
#....# # ##.#
# # $* * #  #
#@       * .#
#############

; 0955_the_magic_tower_6
#############
#+   . . .  #
# #.$#$#$$# #
# #..# #  # #
# $$.$ ## . #
# # .# #  $##
# $   .$$ $ #
# $#$#.#..# #
#  .$ .$$.$ #
# $.## #..  #
#$#.##$#$$###
# .   .   ###
#############

; 0955_the_magic_tower_7
#############
#   #   #   #
# $ $.#.$ $ #
# $.$.$.$.$ #
##$...#...$##
# .$.$ $.$. #
# #.$$ $$.# #
# .$.$ $.$. #
##$...#...$##
# $.$.$.$.$ #
# $ $.#.$ $ #
#   #   #  @#
#############

; 0955_the_magic_tower_8
#############
#@   ####  ##
# ## ...$$ ##
# ##$$ #$..##
# $.....$$. #
# $$$$$.$.# #
# ....$#$.. #
##$$#.$.$$.##
# ......... #
# #$$$$$$$# #
#  $ # $ $  #
##     #   ##
#############

; 0955_the_magic_tower_9
#############
#     @     #
# $ $ $ $ $ #
# #### $ $$ #
# . #  # #  #
# * * *.*.###
# ***## # $ #
# * *..*.*. #
# . *# # ## #
# $ *...*.* #
# # * $$# $ #
#   .       #
#############

; 0955_the_magic_tower_10
#############
##    .     #
#  $ $.$ $  #
# * # # # * #
#.#.#.#.#.#.#
# $ $ # $ $ #
##$##.#.##$##
# $ $ # $ $ #
#.#.#.#.#.#.#
# # # # # * #
#  $ $.$ $  #
#@    .    ##
#############

; 0955_the_magic_tower_11
#############
#  .$..# $. #
# # $ . .$$ #
#. .$#$$ #. #
#$#$$ .$*$$.#
#. .$. #. * #
# # $$ $ .$.#
#. .. .#..$ #
#$#$$# $$$$.#
# . .# . .. #
#$## .$*$#$ #
#    $+$..  #
#############

; 0955_the_magic_tower_12
#############
# . $.  # . #
#.$## $.$.$*#
# .  . .$ . #
#$$#$$$$#*$.#
# . * ..$.  #
# $#$.$ # ###
# . * . *.  #
#.# $$*$$## #
# . *.$.$ ..#
#$$*$   *$ $#
#  .. $  . +#
#############

; 0955_the_magic_tower_13
#############
#.$. . . .$.#
# .$.$.$.$. #
# $. #*# .$ #
# .$## ##$. #
# $.*   *.$ #
# .$## ##$. #
# $. # # .$ #
# .$.$.$.$. #
# $.$. .$.$ #
#$$$*$#$*$$$#
#+         .#
#############

; 0955_the_magic_tower_14
#############
# *.   ##   #
#*@$.$ ## * #
# *$$.  # * #
#$ .*.* $*  #
# * .*$ *   #
#.$*$ #**$*.#
#    # *  $.#
#.. ## $*.*$#
#.$#  .*  . #
#  $ # *#.$ #
# $.##      #
#############

