; 0937_compact_catalysts_04_1
###########
#@ #      #
#    #$ # #
# $..$..$ #
# #$$$$#$ #
# $.#..$.##
##$...... #
# $..#$$# #
# *#  $ * #
#     #   #
###########

; 0937_compact_catalysts_04_2
###########
#@#       #
#   $#$$  #
# $......##
# #$$$#$. #
# $    $$ #
# . # $#. #
##. $  $.##
# .**.**. #
#   #     #
###########

; 0937_compact_catalysts_04_3
###########
#@#       #
#  .*#**  #
# *.  *  ##
# #***#*  #
# *    ** #
#   #**#  #
##  *  * ##
#  ** $$  #
#   #     #
###########

; 0937_compact_catalysts_04_4
###########
#@#       #
#   $#$$  #
# $...$..##
# #$$$#$..#
# $....$$.#
#  .#$$#..#
##$....$.##
# $ $ $$  #
#   #     #
###########

; 0937_compact_catalysts_04_5
###########
#@#       #
#    #$$  #
#  $   $ ##
# #$$ #$  #
# $ $  $$ #
#   #$$#  #
## **.*..##
#  ...***.#
#  .#.....#
###########

; 0937_compact_catalysts_04_6
###########
#@#       #
#    #*$  #
#  *   * ##
# #** #*  #
# * *  ** #
#   #**#  #
## ** *  ##
# .   *** #
#   #     #
###########

; 0937_compact_catalysts_04_7
##############
#@  #        #
# $$$$$$$# $ #
# ..#..#.. # #
# #.$..$..$  #
# $...#$$*#  #
#  #...$..$$ #
# $$$#.$#.$  #
# $ $..*..#$ #
#            #
##############

; 0937_compact_catalysts_04_8
##############
#@  #        #
# *******# * #
# . #  #   # #
# # *  *  *  #
# *   #***#  #
#  #   *  ** #
# ***# *# *  #
# * *  *  #$ #
#            #
##############

; 0937_compact_catalysts_04_9
##############
#@  #        #
# $******# * #
# $ #  #   # #
# # *  *  *  #
# *   #***#  #
#  #   *  ** #
# ***# *# *. #
# * *  *  #* #
#          . #
##############

