; 0630_fibo_challenge_1
     ###### 
     #    # 
     # #### 
 ##### #  ##
 # .@#  *  #
 #$.$#  *  #
 # * #  * ##
 # * ## * # 
 # * ## * # 
 # * ## * # 
 # * ## * # 
 # * ## * # 
 # * ## * # 
 # * ## * # 
 # * ## * # 
 # * ## * # 
 # * ## * # 
 # * ## * # 
 # * ## * # 
 # * ## * # 
 # * ## * # 
 # * ## * # 
 # * ## * # 
 # * ## * # 
 # * ## * # 
 # * ## * # 
 # * ## * # 
## *  # * # 
#  *  #$.$# 
#  *  # . # 
##  #   ### 
 ########   

