; 1009_4x4s_1
  ####
  #@ #
###  #
#  * #
#  * #
######

; 1009_4x4s_2
####  
# @###
# *  #
# *  #
###  #
  ####

; 1009_4x4s_3
  ####
  # @#
###  #
# *  #
#   ##
##### 

; 1009_4x4s_4
##### 
#   ##
#* * #
#@#  #
#    #
######

; 1009_4x4s_5
######
#    #
# $. #
##$. #
 #@ ##
 #### 

; 1009_4x4s_6
 #####
 #. .#
### $#
#@ $ #
#    #
######

; 1009_4x4s_7
######
#.   #
#  $ #
# #$##
#. @# 
##### 

; 1009_4x4s_8
##### 
#   ##
#  $ #
##$  #
 #@..#
 #####

; 1009_4x4s_9
##### 
#   ##
#..$ #
#@$  #
###  #
  ####

; 1009_4x4s_10
######
#    #
# #  #
#@*$.#
##   #
 #####

; 1009_4x4s_11
######
#@*  #
# $ *#
# #  #
#.   #
######

