; 0246_grigr_challenge_1
           ###           
          ##@##          
         ##   ##         
        ##  *  ##        
       ##  ***  ##       
      ##  * * *  ##      
     ##  * * * *  ##     
    ##  * * * * *  ##    
   ##  * * *** * *  ##   
  ##  * * * * * * *  ##  
 ##  * * * * * * * *  ## 
##  * * * * * * * * *  ##
#  * * * * *** * * * *  #
# * *** *** $ *** *** * #
#  * * * * *** * * * *  #
##  * * * * * * * * *  ##
 ##  * * * * * * * *  ## 
  ##  * * * * * * *  ##  
   ##  * * *** * *  ##   
    ##  * * * * *  ##    
     ##  * * * *  ##     
      ##  * * *  ##      
       ##  ***  ##       
        ##  *  ##        
         ##   ##         
          ##.##          
           ###           

; 0246_grigr_challenge_2
          #####         
         ##   ##        
        ##  *  ##       
       ##  * *  ##      
      ##  * * *  ##     
     ##  * *** *  ##    
    ##  * * * * *  ##   
   ##  * * * * * *  ##  
  ##  * * * * * * *  ## 
 ##  * * * *** * * *  ##
##  * * * * * * * * *  #
#. *** *** *$* *** ***@#
##  * * * * * * * * *  #
 ##  * * * *** * * *  ##
  ##  * * * * * * *  ## 
   ##  * * * * * *  ##  
    ##  * * * * *  ##   
     ##  * *** *  ##    
      ##  * * *  ##     
       ##  * *  ##      
        ##  *  ##       
         ##   ##        
          #####         

; 0246_grigr_challenge_3
        #############       
       ##           ##      
      ##  * * * * *  ##     
     ##  * * * * * *  ##    
    ##  * * * * * * *  ##   
   ##  * * * * * * * *  ##  
  ##  * * * * * * * * *  ## 
 ##  * * * * *** * * * *  ##
##  * * * * * * * * * * *  #
#. *** *** * *$* * *** ***@#
##  * * * * * * * * * * *  #
 ##  * * * * *** * * * *  ##
  ##  * * * * * * * * *  ## 
   ##  * * * * * * * *  ##  
    ##  * * * * * * *  ##   
     ##  * * * * * *  ##    
      ##  * * * * *  ##     
       ##           ##      
        #############       

; 0246_grigr_challenge_4
    ###########    
   ##         ##   
  ##  * * * *  ##  
 ##  * * * * *  ## 
##  * * * * * *  ##
#  ******$******@.#
##  * * * * * *  ##
 ##  * * * * *  ## 
  ##  * * * *  ##  
   ##         ##   
    ###########    

; 0246_grigr_challenge_5
          #####          
         ##   ##         
        ##  *  ##        
     ####  *$*  ####     
    ##    * * *    ##    
   ##  * * * * * *  ##   
  ##  *** * * * ***  ##  
 ##  * * * * * * * *  ## 
##  * * * * * * * * *  ##
#  * * * * * * * * * *  #
# * * *** *.*.* *** * * #
#  * * * * * * * * * *  #
##  * * * * * * * * *  ##
 ##  * * * * * * * *  ## 
  ##  *** * * * ***  ##  
   ##  * * * * * *  ##   
    ##    * * *    ##    
     ####  *$*  ####     
        ##  *  ##        
         ## @ ##         
          #####          

