; 0876_easy_3_boxes_1
     #### 
 #####  # 
## $ $  # 
#  . #  # 
#.  ## ## 
#@#.##  # 
#   $   # 
##  #  ## 
 #######  

; 0876_easy_3_boxes_2
#######
#@ #  #
#  # .#
# $$ $#
##   .#
 #  . #
 ######

; 0876_easy_3_boxes_3
 #######
##  $. #
#..    #
#  $ ###
####$  #
#@     #
#   #  #
########

; 0876_easy_3_boxes_4
#######  
#.    ###
###     #
#  #  $ #
#.  # ###
# @ #  # 
##  $  # 
 # *  ## 
 ######  

; 0876_easy_3_boxes_5
########
#.   ..#
#  #####
#     ##
# $  $ #
#### $@#
   ##  #
    ####

; 0876_easy_3_boxes_6
 #######
 # .$  #
##     #
#..  ###
####$  #
#    $@#
#   #  #
########

; 0876_easy_3_boxes_7
 #####  
 #   ## 
 # @$ # 
####  # 
#  $ ###
#..    #
#   $. #
########

; 0876_easy_3_boxes_8
 ####   
##+ #   
# . ####
# $$   #
##* ## #
 #  ## #
 #     #
 #######

; 0876_easy_3_boxes_9
#########
#  #    #
#     $ #
#   ##  #
###$.#$##
#     @# 
# ## # # 
#..    # 
######## 

; 0876_easy_3_boxes_10
###### 
#  . # 
#. . ##
#$ $$ #
#  #@ #
#  #  #
#######

; 0876_easy_3_boxes_11
           
###########
#   ## .  #
# #$##$#  #
#   $    ##
#  @ #  . #
#  ####.# #
####      #
   #    ###
   ######  

; 0876_easy_3_boxes_12
          
######### 
#   #.  # 
#. .    # 
#  #$#@ # 
# $  #### 
####    # 
#    $  # 
#   #   # 
######### 

; 0876_easy_3_boxes_13
#####     
#   ####  
#  $#  #  
##     #  
#  $#  ###
#  .#    #
#.#$#    #
#.  ### @#
##### ####

