; 1007_aigonan_1
##########
#  #######
#@*      #
#*  ###  #
##. ### ##
## #### ##
## ####  #
##    $  #
######   #
##########

; 1007_aigonan_2
##### #####
#.. ###   #
#.@$  $   #
#   ###   #
### #### ##
 ##$#### ##
 #   ##   #
 #        #
 #   ##   #
 ##########

; 1007_aigonan_3
###########
#.. #######
#..  ######
##        #
###   $$$ #
###    $@ #
###       #
###########
###########
###########

