; 0441_numbers_1
 ##### 
## @.##
# $$* #
#  #. #
#     #
# $#  #
##  .##
 ##### 

; 0441_numbers_2
  #### 
###  # 
#    # 
#    # 
###$$# 
  #..# 
 ##..##
 #@$$ #
 #    #
 ######

; 0441_numbers_3
 #####  
##   ## 
#    .# 
# .#  # 
###@  # 
 # $ ## 
## $ #  
# $ ####
# $.   #
#    . #
########

; 0441_numbers_4
########
#      #
#@$ $$ #
####  ##
#  ##  #
#  #. .#
#   .  #
##    ##
 ###### 

; 0441_numbers_5
   #### 
  ##  # 
 ##   # 
## #.$##
#  ..@ #
#  $$* #
####   #
   #  ##
   #### 

; 0441_numbers_6
  #######
 ##     #
##    $ #
# $ #####
# $$@$ ##
#       #
#####   #
#. # #  #
#. .##  #
#       #
##. .  ##
 ####### 

; 0441_numbers_7
 ###### 
## .. ##
#.@*$  #
#  #   #
#  #####
#. $  ##
#  $   #
#.###  #
# $ $  #
##    ##
 ###### 

; 0441_numbers_8
########
#      #
# $ $  #
#### $ #
  #.$ ##
  #. ## 
 ##.@## 
 # .  # 
 # $$ # 
 # . ## 
 ##.$#  
  #. #  
  ####  

; 0441_numbers_9
 ##### 
## @ ##
# .$. #
# $.$ #
##$.$##
#  .  #
# $.$ #
# .$. #
##   ##
 ##### 

; 0441_numbers_10
 #######  
##  .  ## 
#  *.*  ##
# $#.#$  #
# $   $  #
#######  #
#   ###  #
# $.$.$  #
## .@.  ##
 ######## 

