; 0316_various_1
####  
#  #  
#  #  
#  ###
#  $ #
#.$. #
# @###
####  

; 0316_various_2
 #######
 #     #
##  .. #
#@$ $ ##
# $.### 
##  #   
 ####   

; 0316_various_3
##### 
#  +##
# *$ #
##   #
# $* #
#  * #
#  .##
##### 

; 0316_various_4
######
# $. #
# *  #
#@$  #
##$. #
# $. #
#  .##
##### 

; 0316_various_5
##### 
#  .##
# .$ #
# $$ #
## . #
# $* #
#  +##
##### 

; 0316_various_6
########
#    $.#
#  $# .#
#   .$@#
#  $.$.#
########

; 0316_various_7
  #### 
### @# 
#   $##
#.** .#
#  $ ##
###  # 
  #  # 
  #### 

; 0316_various_8
  #### 
###  # 
#   $# 
#..$@# 
#  .$##
###.$ #
  #   #
  #####

; 0316_various_9
######## 
#   #  ##
#  ..   #
##  # $ #
 # .*$$##
 #  .$@# 
 ####### 

; 0316_various_10
 ####### 
 # .#  ##
## ..   #
#   #$$ #
#  $* @##
## $.  # 
 ####### 

; 0316_various_11
 ####### 
 #  #  ##
## ..   #
#   #$$ #
# .$* @##
## $.  # 
 ####### 

; 0316_various_12
 ####### 
 #  #  ##
##  .   #
# ..#$$ #
#  $* @##
## $.  # 
 ####### 

; 0316_various_13
  #### 
###  # 
#  * ##
#.. . #
# $$$ #
### @##
  #  # 
  #### 

; 0316_various_14
  #### 
### @# 
#  $$# 
#... ##
# $ $ #
###  .#
  ##  #
   ####

; 0316_various_15
########
#. . . #
#  .$  #
# $$$###
#  $+#  
######  

; 0316_various_16
########
# .  $@#
#$.$** #
#     ##
#.  ### 
##  #   
 ####   

; 0316_various_17
########
#   .$@#
#$.$*$ #
# .   ##
#.  ### 
##  #   
 ####   

; 0316_various_18
 ######## 
 # .$ . # 
##$.  *$##
# .$$.$  #
#@*  .   #
##########

; 0316_various_19
####  
#  #  
#  #  
#  #  
# @#  
# $###
#.$  #
#.$. #
#  ###
####  

; 0316_various_20
 ####### 
##  #  ##
#   ..  #
# .$#$$ #
##  * @##
 # $.  # 
 ####### 

; 0316_various_21
   #### 
####@ # 
#   $ # 
#.*..$##
# $  $ #
####  .#
   ##  #
    ####

; 0316_various_22
   #####
####   #
#   $  #
#...$.##
#   $.# 
####$$# 
   # @# 
   #### 

; 0316_various_23
####  
#  #  
#  #  
#  #  
#  #  
# $#  
# @#  
#.$###
#.$  #
#.$. #
#  ###
####  

; 0316_various_24
  ####  
###  #  
# . .#  
#  $ #  
### .#  
  #$ #  
  #  #  
  #$.###
  # $ @#
  #  * #
  #  ###
  ####  

; 0316_various_25
     #####
######   #
#   $ $  #
#.....$.##
# $   $.# 
######$$# 
     # @# 
     #### 

