; 0294_churros-like_1
###### 
#  @ ##
# $$  #
# # * #
#   $##
##...# 
 ##### 

; 0294_churros-like_2
    ####    
#####  #    
#   *$.###  
#   #@$  #  
#####  #.#  
    #    #  
######## ## 
#         # 
#   ###   # 
##### # ### 
#   # # ####
#   ###    #
##         #
 #  #####  #
 ####   ####

; 0294_churros-like_3
 ##### 
 #   # 
 #@$.# 
 #  *# 
###$.# 
#   *# 
#  $.# 
## $.# 
 #   # 
 # ### 
 #  ## 
## $.# 
# $$.# 
#  $.# 
# $ .##
####. #
 # $. #
 #    #
 ######

; 0294_churros-like_4
######
#  ..#
# $  #
# $* #
##@ ##
 #### 

; 0294_churros-like_5
##########
#        #
# $.$.$. #
# .$.$.$ #
# $.$+$. #
# .$.$.$ #
# $.$.$. #
# .$.$.$ #
#        #
##########

; 0294_churros-like_6
 ####   
##  ### 
#@$   ##
# **.  #
##* .  #
#  $ ###
#   ##  
#####   

; 0294_churros-like_7
######  
# @ .#  
# *  #  
##$#####
#      #
#      #
#####  #
    ####

; 0294_churros-like_8
    ####
  ###@ #
###    #
# $$#. #
#.    ##
# $ # # 
###  .# 
  ##### 

; 0294_churros-like_9
 #######
 # .   #
 # #.$ #
##$  .$#
#   #$.#
# $.#@ #
#  #####
####    

; 0294_churros-like_10
   #### 
####  # 
#  $  # 
# .*.$##
##...$ #
 #  $$@#
 #    ##
 ###### 

; 0294_churros-like_11
   #### 
 ###  # 
## $ $# 
# ....##
# .$ . #
# $$ $@#
#  #####
####    

; 0294_churros-like_12
####    
#  #####
#  $   #
# $..  #
##  ####
### ##  
# $  #  
#.@$ #  
## .##  
 ####   

; 0294_churros-like_13
####  
#  ###
#  . #
# ** #
#@$  #
##$###
## $ #
#  $ #
# .. #
# .  #
######

; 0294_churros-like_14
#######
# .$  #
# $.. #
# $.* #
#  $ ##
# @### 
####   

; 0294_churros-like_15
 ####  
 #  ###
##$.. #
# *.* #
#  $$@#
#     #
#######

; 0294_churros-like_16
####    
#  ###  
#    ###
# .*$. #
##$#  @#
 #     #
 ###  ##
   #### 

