; 0904_simple_1
########
# .$.$ #
# $ .  #
#.$$. *#
# @*   #
########

; 0904_simple_2
  ######
  #.   #
#### * #
# $   ##
#+*$#  #
#$ .$. #
#   .$ #
########

; 0904_simple_3
     #####
######   #
#@ $  $  #
# $...#$##
###..##  #
#  .$  $ #
#   #    #
##########

; 0904_simple_4
####### 
# . . ##
#.$##$ #
#    $@#
#.. $$##
#     # 
####### 

; 0904_simple_5
########
#.     #
#..$ # #
#.$#   #
#$$ $  #
#.@#   #
########

; 0904_simple_6
 #######
 #   * #
##*#   #
# $ ** #
# . #  #
##   * #
 #  #@ #
 #######

; 0904_simple_7
 #######
 #   * #
##*#   #
#@ * * #
# * #$ #
##   . #
 #  #  #
 #######

; 0904_simple_8
 ####    
 # @#####
 #$$  $ #
## #. # #
#  # $  #
#  .. ###
### . #  
  #####  

; 0904_simple_9
####### 
#  #  # 
#   . # 
#. #  ##
## $.$ #
 #$$* .#
 #@ #  #
 #######

; 0904_simple_10
   #####
####   #
# $  $ #
#..  ###
# .#$###
##$    #
 #.   @#
 #######

; 0904_simple_11
########
#. . $ #
##$##  #
##@* ..#
# $#.$ #
#   $$ #
# $ .. #
########

; 0904_simple_12
########
#.$@*  #
#. * . #
#.$# $ #
#  * ###
# $  #  
##   #  
 #####  

; 0904_simple_13
########
# .. * #
#. . * #
#*$#   #
# .$ # #
#  $$$ #
###@ ###
  ####  

; 0904_simple_14
#####   
# . ####
#.$*@. #
#. #$$ #
#$.$ # #
#      #
###  ###
  ####  

; 0904_simple_15
 #######
##  $. #
# . $. #
# .#@$$#
#*.$$# #
#     .#
###  ###
  ####  

