; 0952_zodiac_collection_1
 ######### 
##   #   ##
#  **$**  #
# *  *  * #
# *  *  * #
# #* * *# #
#   #*#   #
##   +   ##
 #   #   # 
 ######### 

; 0952_zodiac_collection_2
##########
#.. ## ..#
#  *  *  #
##  **  ##
#  *  *  #
# * $$ * #
#* $  $ *#
# * $$ * #
#  *  *  #
###@.. ###
  ######  

; 0952_zodiac_collection_3
###########
#    #    #
# **$#$** #
#  $.*.$  #
# $#.#.#$ #
#   .@.   #
# $#.#.#$ #
#   .*.   #
# **$#$** #
#    #    #
###########

; 0952_zodiac_collection_4
   ########  
  ##      ## 
 ##  *.**  # 
##  * $  . # 
#  ** ##   ##
# *$ .$ **  #
#  ** $. $* #
#    ## **  #
## .  $ *  ##
 #  **.*  ## 
 ##   @  ##  
  ########   

; 0952_zodiac_collection_5
    #####  
 ####   ## 
 #   **  ##
 # $.  .$ #
 ##. #$$. #
##  *#  . #
#   * $#*##
# ***$  * #
#.  *  .$ #
# ** #*   #
###   * * #
  #### * @#
     #   ##
     ##### 

; 0952_zodiac_collection_6
########### 
#    #    ##
# * * * *  #
#  *$* * * #
#  * * . * #
#  * *#* * #
## . . * * #
 # * *#$*$ #
 #     * * #
 ##### @  ##
     ###### 

; 0952_zodiac_collection_7
  #######  
 ##     ## 
##  *.*  ##
#  * $ *  #
# *$###$* #
#  *   *  #
# *** *** #
#   # #   #
# **.*.** #
#    @    #
###########

; 0952_zodiac_collection_8
 ########    
##      ##   
# * * *  #   
#  *$*$* #   
#  * * * ### 
## * * *   ##
 # * * * *  #
 # * . **.* #
 #   #   *  #
 ####### @ ##
       ##### 

; 0952_zodiac_collection_9
   ####### 
####     ##
#  # ***. #
# $#   ** #
#  ## * * #
# *  *  * #
#   . #   #
# $.#  ####
# * $* #   
##@    #   
 #######   

; 0952_zodiac_collection_10
############   
#          #   
#.  #  **  #   
# *   * *#$####
#  *#*  *     #
## * .  * *** #
 #  * # * * * #
 ## *  # *$ *@#
  # $ # * *.  #
  ### ** #   ##
   #      #### 
   ########    

; 0952_zodiac_collection_11
###########
#  * * *  #
# * * * * #
#  $ $ $  #
#  . . . @#
# * * * * #
###########

; 0952_zodiac_collection_12
##########
#        #
# **## * #
# $.  .$ #
# $.  .$ #
##***.**##
# $. $.$ #
# $.  .$ #
# * ## * #
#      @ #
##########

