; 0164_cosmonotes_1
######## 
#@  #  # 
# ..   ##
##.##   #
 #  $$# #
 ###$   #
   #  ###
   ####  

; 0164_cosmonotes_2
 ####     
 #  ######
 #       #
## ####  #
#@* ### ##
#  * ## # 
##  * # ##
 ## .$#  #
  ##     #
   ####  #
      ####

; 0164_cosmonotes_3
 #########
 #       #
 # ##### #
 # #   # #
 # $.#@# #
###$.  # #
#  $.### #
# #$.    #
#    #####
######    

; 0164_cosmonotes_4
 #####   
 #   ####
 # #$$  #
## #@ # #
#  #$. .#
#  .$. ##
###  # ##
  ##    #
   ##   #
    #####

; 0164_cosmonotes_5
      #### 
#######  ##
#@$       #
# *###  # #
##..    # #
##*#      #
# $  ######
#   ##     
#####      

; 0164_cosmonotes_6
 ########  
 #  ##  #  
 #.$   .###
 # .## $  #
##$### #  #
# $    # ##
# @ #.    #
#######   #
      #####

; 0164_cosmonotes_7
  #####  
  #   ###
  # #*  #
 ##+*   #
 #   # ##
##$#*#  #
#    *  #
#   ##  #
#########

; 0164_cosmonotes_8
######   
#    ####
# ## .  #
# ###*# #
# # $@# #
# # * # #
#   *   #
## # ####
 #   #   
 #####   

; 0164_cosmonotes_9
  #######
  #     #
### ### #
# $ $ # #
#...@.# #
# $ $ # #
### ### #
 #      #
 #   ####
 #####   

; 0164_cosmonotes_10
#### ##### 
#  ###   # 
#  $     # 
#  #$##$## 
## #@    # 
 # #$# # ##
 # # . .  #
 #    #   #
 #  #. .###
 ########  

; 0164_cosmonotes_11
   #####  
####. .###
# $  #   #
#@# .$.$ #
# $ # # ##
###     # 
  ####### 

; 0164_cosmonotes_12
  ########
 ##  #   #
##       #
#  # .# ##
# $* **$# 
## ##.# # 
 # #@   # 
 #    ### 
 ######   

; 0164_cosmonotes_13
 #######
 #  #  #
 #     #
## ##  #
#   #.##
#   *  #
### *  #
  #$* ##
  #@ ## 
  ####  

; 0164_cosmonotes_14
   ####  
####  ## 
# $    ##
#.+***  #
# $     #
#####  ##
    #### 

; 0164_cosmonotes_15
 #####  
 #@. #  
##$.$## 
#  *  ##
#  .$  #
####   #
   #####

; 0164_cosmonotes_16
  ######  
 ##    #  
## @## #  
#  #  $###
#  ....$ #
#  # $   #
######$ ##
     #  # 
     #### 

; 0164_cosmonotes_17
#########
#   #   #
# $   $ #
##$#@#$##
 #. ..  #
 ## .#  #
  ##   ##
   ##### 

; 0164_cosmonotes_18
  #######
###     #
#   ### #
# #$* # #
#  $. # #
###$.   #
  #@. ###
  #####  

; 0164_cosmonotes_19
 ####   
 #  ### 
## * @# 
#  *#$##
#  .   #
## * # #
 # * # #
 ## #  #
 #    ##
 #   ## 
 #####  

; 0164_cosmonotes_20
   ####   
####@ ### 
#  $ $  ##
# #$#$#  #
# # . .  #
# # . . ##
# ## #### 
#    #    
######    

