; 0182_serena_03_1
##########   
#        ##  
# $$# $$$.## 
#  @ # $ ..##
## $ #  $*..#
 ### ##$ ...#
 # $ $   ...#
 #   #  #####
 ########    

; 0182_serena_03_2
  ######    
 ##    #    
## $$$ #    
# $  $ #    
#   $$ #### 
# $$ $ #..# 
## @ # #..##
 ##$ $ #...#
 #  $   ...#
 #      ...#
 ###########

; 0182_serena_03_3
  ####    
  #  ###  
 ## .  #  
 #  #  #  
 #$.#. #  
 # .#  #  
 #$.#.@###
 # .#$$  #
 # ## #$ #
## .$.#  #
#  $. #$ #
#  $  $  #
####    ##
   ###### 

; 0182_serena_03_4
    ########### 
    #         # 
##### $$$$$$$$# 
#         # # # 
# ####### # # # 
#  ###### # # ##
#       . . . .#
#       ########
##### # . . . .#
    # #     ##@#
   ## ####  ####
   #        #   
   #   ###  #   
   ##### ####   

; 0182_serena_03_5
#############  
#           #  
# $ $ $ $#$ #  
# $ $ $@$   #  
# $#$#$ ### #  
# $ $   ### ###
# $  #        #
#  #  . .. ...#
####  ####### #
   #  #######.#
  ## ..... ...#
  #   #########
  #   #        
  #####        

; 0182_serena_03_6
    #####       
 ####   ####    
 # $  #  $ #    
 # $    $  # ###
 # $. @$ # ###.#
 # *  $    # . #
##.$ $ ### #.$ #
#...........  $#
##.$ $ ### #.$ #
 # *##$    # . #
 # $.  $## # #.#
 # $    $  # ###
 # $ ### $   #  
 #   # ####  #  
 #####    ####  

; 0182_serena_03_7
    #####    
 ####   #### 
 #    $    # 
 # ###$### # 
## # @$  # ##
#  #  $  #  #
#...*.*.*...#
#  #  $  #  #
## #  $  # ##
 # ###$### # 
 #    $    # 
 ####   #### 
    #####    

; 0182_serena_03_8
#####           
#   #  #####    
# $$####   #### 
#    ..... .  # 
####$ ### #.# # 
   #  # @ $.# ##
   #$ #.# #.#  #
  ##  $.$$$.$$ #
  #   #.$  .   #
  #   #.$  $$ ##
  ###$#..$ $  # 
    #   ..$$  # 
    #### . #### 
       #####    

; 0182_serena_03_9
         #####
       ###   #
 ####### $$$ #
## ...# .. ..#
# $$$.# .$$$.#
#   . @ $ .$$#
# $*$$# .$$$.#
#  ...# .. ..#
######## $$$ #
       # #   #
       #######

; 0182_serena_03_10
        #####  
  #######   #  
  #  $ $ $ $#  
  #.........###
  #####  ***  #
 ######$ ..*# #
##    # ...*  #
# $$$ #$.$..# #
#     @ $$..  #
# $$$$# .$$$ ##
#     # ..  ## 
######## $$$#  
       #    #  
       ######  

; 0182_serena_03_11
 ########## 
 #        # 
## $$$ $$$##
# .$ $ $ $.#
# .$.$#$.$.#
# .* .#. ..#
##.$.$#$.$.#
 #.$ $.$ $.#
 #$$ $.$ $ #
 #   .@.   #
 #####.  ###
   #.....#  
   #######  

; 0182_serena_03_12
  ######## 
###      # 
# #$$.$..# 
# $.. #$.# 
#   .  ..# 
##$$# $ ###
 # $ # $$ #
 #..      #
 #####@####
     ###   

; 0182_serena_03_13
 #########
 #   . $@#
## $ $ $$#
# $.  #$ #
#   $.#  #
## $#  #.#
 #  $$$$ #
 #..#....#
 ##.##.#.#
  ########

; 0182_serena_03_14
 #########
 #   . $@#
## $ $$$$#
# $#  .$ #
#.. $. # #
##.$#  #.#
 #. $$$$ #
 #..    .#
 ##.##.#.#
  ########

; 0182_serena_03_15
     ####  
  ####  ###
  #  $  $@#
 ##.#$#.$ #
 #  .$ .$ #
##   $.$$$#
# ... .$  #
##  . #$..#
 ##    $. #
  #########

; 0182_serena_03_16
#########  
#.#.#   #  
# *.$$$.#  
# $     #  
#$$$$$$$###
#.    @   #
#.$###$$$ #
#.........#
###########

; 0182_serena_03_17
     #######
### ##     #
#.# #  $## #
# ###$$$   #
# $    $ # #
#$$#.$$$## #
#. .. @  # #
#. ###$$$# #
#..#...... #
##         #
 ###########

; 0182_serena_03_18
 ########   
 #....#.#   
 #...$#.####
## $.... $ #
#  $   $## #
# ###$$$ # #
# $    $   #
#$$#.$$$#$ #
#. .. @    #
#. ###$$$$ #
#.##...$ $ #
####       #
   #########

; 0182_serena_03_19
##########
#......  #
#$# .....#
# $ #$$$$#
# #$  .# #
#  $ $.$ #
# #$ @$  #
# $ $$$$.#
#     ...#
##########

; 0182_serena_03_20
########  
#@*..*.#  
#*....*#  
#  ##.##  
#    #####
# $  $   #
#  $ $ $ #
##$ $ $  #
 #       #
 #########

; 0182_serena_03_21
#############
#    # . $ .#
# $$ #$*. ..#
#  $ # .*$*.#
# $$ #$*. ..#
#  $ # .*$*.#
# $$  $*. ..#
#  $$$ *.**.#
#   #@   ####
##########   

; 0182_serena_03_22
    #####     
#####   ######
# @          #
#  $ ## $##$ #
#  ###..     #
###   ..#$$ ##
 #   #..#    #
 ## $#..#$$$##
 #   #..#    #
 #  $$*.#$$ ##
 ##  #..     #
  #  #   #####
  ########    

; 0182_serena_03_23
    #####     
   ##   ######
 ###.   .    #
 #@$.....##$##
 ###.#...   # 
 ## $$..#$$ ##
 #  $  .#    #
##  $#    $$ #
#   $  #     #
#   $  .#$$ ##
### $# #    # 
  #  #   #### 
  ########    

; 0182_serena_03_24
      ###       
#######@########
#   #..*...    #
# $ #......##$##
# $$#..#...   # 
#   #.....#$$$##
## $#.....#    #
 #   ..#   $$$ #
##$$$ $  #     #
#   $ $  .#$$ ##
# $## $# #    # 
#      # $  ### 
### $$$$$$$ #   
  #         #   
  ###########   

; 0182_serena_03_25
          #### 
###########  # 
#@$ $ $ $    # 
#         ## # 
# $#$#$#$ ## # 
#         ## # 
# $#$#$#$ ## # 
#         ## # 
# $#$#$#$ ## ##
#             #
# $#$#$ $...  #
#   ...##..####
####...... #   
   #...... #   
   #########   

; 0182_serena_03_26
         ####### 
         #     ##
###########$ $  #
#@  ....     #$ #
#  $###.$ #$ $ ##
##    #. $$  #  #
##$#  #.    $#$ #
#  #$$.##### #  #
# $#  .....$ #$ #
#  #$ ..##.$ $  #
# $#  $$ ..$  # #
#  $$$  ..    # #
##  ....  $ $   #
 ###.###$$  #$  #
  #........ $  ##
  ##########  ## 
           ####  

