; 0298_hail_and_solve_1
######
# . .#
# $$$#
# @# #
#.   #
######

; 0298_hail_and_solve_2
######
#    #
#   .#
##$*$#
 #@ .#
 #####

; 0298_hail_and_solve_3
######
# *  #
# $$ #
#  #@#
#  ..#
######

; 0298_hail_and_solve_4
####  
#  ###
# *$ #
#.*  #
#   @#
######

; 0298_hail_and_solve_5
######
# *  #
# $* #
#  # #
#.  @#
######

; 0298_hail_and_solve_6
######
#    #
#.$* #
#  # #
#   @#
######

; 0298_hail_and_solve_7
####   
#  ### 
# *$.##
#     #
###  @#
  #   #
  #####

; 0298_hail_and_solve_8
#######
# $ . #
# $#  #
#@*   #
#.#   #
#######

; 0298_hail_and_solve_9
 ######
 # @  #
##*#  #
# .$$.#
#    ##
#  ### 
####   

; 0298_hail_and_solve_10
#######
#     #
# .#  #
##*   #
# *$ ##
#@  ## 
#####  

; 0298_hail_and_solve_11
  #### 
###  # 
#.# $##
# *   #
#@$  .#
#######

; 0298_hail_and_solve_12
####    
#  #####
# *.   #
# $ $  #
# @#####
#. #    
#  #    
####    

; 0298_hail_and_solve_13
 ####   
##  ##  
#    ###
# # $  #
#@*.$. #
## # ###
 #   #  
 #####  

; 0298_hail_and_solve_14
########
#    . #
# $ $  #
###@####
#  $  # 
#    .# 
#### .# 
   #### 

; 0298_hail_and_solve_15
   #####
  ##   #
  #  ..#
###$@#.#
#  $   #
#   $ ##
#  #### 
####    

; 0298_hail_and_solve_16
########
#  #   #
#.$**  #
#      #
# @#####
#  #    
####    

; 0298_hail_and_solve_17
  ######
  # . .#
  #  # #
  #$ # #
###  # #
#  $  @#
#  *  ##
####### 

; 0298_hail_and_solve_18
  ######
###@   #
# $$#  #
#   ##.#
##  * .#
 #  .$ #
 ##  ###
  ####  

; 0298_hail_and_solve_19
###### 
#    # 
#    # 
## $.# 
 #$$$##
 #@...#
 ######

; 0298_hail_and_solve_20
    ### 
 ####+##
##  #* #
#  $ ..#
#   $ ##
#  $ ## 
###  #  
  ####  

; 0298_hail_and_solve_21
 #######
##     #
#   $* #
# #@ ###
# #$$#  
#    #  
#... #  
######  

; 0298_hail_and_solve_22
   ####
####  #
#    .#
#  $$$#
### . #
  # . #
  # @##
  #### 

; 0298_hail_and_solve_23
 ##### 
 #   # 
##  .# 
# $$$##
#  # @#
#.  . #
####  #
   ####

; 0298_hail_and_solve_24
  ######
###   @#
# $.$  #
#  .$###
## . #  
 #  ##  
 ####   

; 0298_hail_and_solve_25
########
#     .#
#    $ #
## #####
# @    #
#      #
#####  #
    ####

; 0298_hail_and_solve_26
#######
#. $  #
# @$  #
##  ###
 #$.#  
 # .#  
 #  #  
 ####  

; 0298_hail_and_solve_27
########
# ..  .#
#  #$$ #
# ## ###
#  @ #  
#  $ #  
###  #  
  ####  

; 0298_hail_and_solve_28
########
#  $  .#
# *$  *#
# # @  #
#.  #  #
########

; 0298_hail_and_solve_29
   ####  
####..#  
#  @  ## 
# $#  .##
# $ $   #
#   ##  #
#########

; 0298_hail_and_solve_30
  #### 
 ##  ##
 # $@.#
## **##
#    # 
#    # 
###### 

; 0298_hail_and_solve_31
 ####    
 #  ##   
##   ####
#. $*.  #
#   *$# #
####@   #
   ######

; 0298_hail_and_solve_32
 ####    
 #  #    
##  #####
#. $ * .#
#   *$# #
####   @#
   ##  ##
    #### 

; 0298_hail_and_solve_33
  ######
### .  #
# $  $ #
# @#* .#
# $ .$##
## .  # 
 ###### 

; 0298_hail_and_solve_34
  #### 
  #  # 
### $##
#.  $ #
# .$# #
#   . #
##@ ###
 ####  

; 0298_hail_and_solve_35
########
#  ##  #
#  ##  #
#  #   #
##$$   #
#.@$#  #
#.. ####
#####   

; 0298_hail_and_solve_36
#####   
# .@####
# $$$  #
##. .  #
 ###   #
   ##  #
    ####

; 0298_hail_and_solve_37
    ####
#####  #
# *  $ #
# ..#  #
#  $   #
#@ #  ##
####### 

; 0298_hail_and_solve_38
   #### 
####  # 
#  #  # 
# * *$# 
# * # ##
#  .@  #
##     #
 #######

