; 0302_orange_1
  #### 
###  # 
#   *# 
# # .# 
#  @$##
### * #
  #   #
  #####

; 0302_orange_2
   ####   
   #  #   
 ###  #   
 #    #   
 # .$#####
###.$    #
# @.$#   #
#    #####
######    

; 0302_orange_3
#########
# @ #   #
# .***$ #
##    # #
 ###    #
   #  ###
   ####  

; 0302_orange_4
#########
#  ##   #
# .@    #
# $*$####
### . #  
  # # #  
  #   #  
  #####  

; 0302_orange_5
    #####
    # . #
    # * #
  ### $##
  #   $ #
### @#* #
#     . #
#   ##  #
#########

; 0302_orange_6
#########
#  ##   #
#   $$  #
# @#$. ##
##  ..## 
 #  ###  
 ####    

; 0302_orange_7
######## 
#   #  ##
#     $ #
##### * #
# . # * #
# * # * #
# * # . #
# *@## ##
# $     #
##  #   #
 ########

; 0302_orange_8
#####     
#   ######
#     *  #
######.# #
##  ##$  #
#@    * ##
#  ###  # 
#  # #  # 
#### #### 

; 0302_orange_9
####    
#  #    
#  #    
#  #    
## #####
 #  $+.#
##  #$ #
#   #  #
#   ####
#####   

; 0302_orange_10
 #####  
 #   ## 
 #  $.# 
 ## $.# 
  ##$.##
### $. #
#      #
#  @ ###
###  #  
  ####  

; 0302_orange_11
######### 
#   #   ##
#        #
#######  #
      #@##
####### # 
#     $$##
#   # #  #
##### .. #
    ######

; 0302_orange_12
######     
#    ######
#    ##   #
### @ #   #
  #  .#  ##
  # #$#  # 
 ## #.#  # 
 #   $   # 
 #  ###  # 
 #  # #### 
 ####      

; 0302_orange_13
 #####     
 #   ###   
 # @$. #   
 ###.$ #   
#### ###   
#    ######
#         #
####  #   #
   ########

; 0302_orange_14
    #####
#####   #
#  @$ # #
# #.*.  #
# # $####
#    #   
#   ##   
#####    

; 0302_orange_15
      ####
  #####  #
  #@ ##  #
###      #
#  $##. ##
#  $  .## 
#  ##  #  
########  

; 0302_orange_16
      ###### 
      #    # 
    ### #$$##
    #    $  #
    # # #$#.#
#####   # ..#
#  .#####  .#
# #    #  @##
# $  #   # # 
####   #   # 
   ######### 

; 0302_orange_17
  ###### 
  #    # 
### #$$##
#    $  #
# # # #.#
#   #  +#
#####  .#
   #   ##
   # # # 
   #   # 
   ##### 

; 0302_orange_18
      #### 
      #  # 
    ###  # 
  ### @  ##
### $* #  #
#   *.    #
# ## ######
#    #     
######     

; 0302_orange_19
#####   
#   #   
#.#$####
#. $   #
#.#$#  #
# @    #
#  #  ##
####### 

; 0302_orange_20
#####   
#   ##  
#    ###
# #  . #
#  $*$@#
###. ###
  #  #  
  ####  

; 0302_orange_21
              #####  
           ####   #  
       #####   $# #  
####  ##      #.  #  
#  #  #  *$.* # ###  
#  #  #   ##  #  #   
#  ####  ####### ##  
## $ ##########   ###
# $*. #  #   #    . #
#  . @#### #$   $*$ #
####  #  #  .###. ###
   # ##  ### # #  #  
   #  #  #   # ####  
  ### ##$$   #       
  #  .#. $####       
  # #$ .. #          
  #   #   #          
  #########          

; 0302_orange_22
########
#      #
#    # #
###*$@ #
 # .#$##
 # .  # 
 #  ### 
 ####   

; 0302_orange_23
 ####   
##  #   
#   ####
#  *$  #
## *@  #
 # .#  #
 #  #  #
 #######

; 0302_orange_24
   ####
 ###  #
##    #
# $* @#
# #. ##
#  .$# 
###  # 
  #### 

; 0302_orange_25
 ####  
 #  #  
 #  ###
 # *$@#
## *. #
#  * ##
#    # 
###### 

; 0302_orange_26
####  ######## ####  
#  ####.  #  ###  ###
#  $ # # *#  $ # $$ #
# $ .#  $ # *  #  # #
##  .#    ##  .#.  .#
### ### #### #### ###
#  @                #
#### #### #### #### #
# .  #    #..  #    #
# $  # $* #  $## $  #
# *# #  # # $  #$ ###
#    #  #.##   #.  .#
#####################

