; 0846_mariposa_1
##################
#..  #  *  #  * .#
#.** #  $  #  $  #
#.#  #$ *$ #$ #$ #
#.#  $  #  $  #  #
#.#  *  #  #  #  #
#+#############. #
#.#  *  #  #  #  #
#.#  $  #  $  #  #
#.#  #$ *$ #$ #$ #
#.** #  $  #  $  #
#..  #  *  #  * .#
##################

; 0846_mariposa_2
##################
#..  #  *  #  * .#
#.** #  $  #  $  #
#.#  #$ #$ #$ #$ #
#.#  $  #  $  #  #
#.#  *  #  #  #  #
#+#############. #
#.#  *  #  #  #  #
#.#  $  #  $  #  #
#.#  #$ #$ #$ #$ #
#.** #  $  #  $  #
#..  #  *  #  * .#
##################

; 0846_mariposa_3
##################
#..  #  *  #  * .#
#.** #  $  #  $  #
#.#  #$ *$ #$ #$*#
#.#  $  #  $  #  #
#.#  *  #  *  #  #
#+#############. #
#.#  *  #  *  #  #
#.#  $  #  $  #  #
#.#  #$ *$ #$ #$ #
#.** #  $  #  $  #
#..  #  *  #  * .#
##################

; 0846_mariposa_4
       ############
       #          #
       # $ $ $.*..#
######### #######.#
#  . $    #. $ $ .#
#@$#$#$$$$.$.$.$..#
#  .      #.     .#
###################

; 0846_mariposa_5
       #######       
       #     #       
       # #$# #       
########  *  ########
#    ## *   * ##    #
# **  *  ###  *  ** #
# *  # *     * #  * #
#  * #  * * *  # *  #
# *# ### # # ### ** #
## #*  #  .  #  ** ##
 #   *  #####  *   # 
 ## ***       *** ## 
  ##  ****$****  ##  
   ##     +     ##   
    #############    

; 0846_mariposa_6
#######   
#     #   
# $**#####
# * *    #
# * **** #
# *  # * #
# *    * #
# *****. #
#       @#
##########

; 0846_mariposa_7
#######     #######
#@ #  #######  #  #
#*   *  ###  *   *#
# * * *  #  * * * #
#  * # * # * # *  #
# * *   *#*   * * #
# *  *       *  * #
# ** #* .#. *# ** #
#  *   * # *   *  #
# $****  #  ****$ #
##      ###      ##
###################

; 0846_mariposa_8
  ###########  
  #    *    #  
  #   *@*   #  
###  * . *  ###
#   *     *   #
#  *********  #
#             #
####### #######
      # #      
      # #      
####### #######
#             #
#  *********  #
#   *     *   #
###  * $ *  ###
  #   * *   #  
  #    *    #  
  ###########  

; 0846_mariposa_9
###########
#    *    #
#   ***   #
#  * * *  #
# *  *  * #
#*@. * $ *#
# *  *  * #
#  * * *  #
#   ***   #
#    *    #
###########

; 0846_mariposa_10
 ####################   
 #                  ### 
 # #*####@#*###  ***..# 
 # # #  ###   * **  *## 
 # # #    # # # #  # #  
 # # #    #   * # ## #  
 # # ######  ** # ## #  
 # *        **  # ## ###
 # # ######**   *    * #
 # # #   #    # # #### #
 # # #####*$**  * # #  #
 # #       # ***# # # ##
## # ##### #      # # # 
# $* *   *****#*##### # 
#    #                # 
####################### 

; 0846_mariposa_11
          ########
          #      #
   #### ###  $   #
   #  ###  # ##$##
   #  $.   # ## ##
   #  # #  # #   #
#####$# # ## #$$ #
#  ##.# # ##   # #
# $   # #. # #$  #
#  #.#. .#$#   ###
## #.#.*...  $$###
 # #.*.. ### #   #
 # #.*..## $ $$$ #
## ###.### $# $  #
#   ##*.$      $ #
#   ...## $   $# #
##.#######@##    #
# $      $ #######
#   ####   #      
#####  #####      

; 0846_mariposa_12
#################
#...............#
#.$$$ $$$ $ $$$.#
#.$ $ $ $ $ $ $.#
#.  $ $@$ $   $.#
#.$$$ $ $ $ $$$.#
#.$   $ $ $ $  .#
#.**$ $$$ $ $**.#
#...............#
#################

; 0846_mariposa_13
########### 
#         # 
# .$.$.$. # 
# $.$.$.$ # 
# .$.$.$. # 
# $.$@$.$ # 
# .$.$.$. # 
# $.$.$.$ ##
# .$.$.$.  #
#          #
############

; 0846_mariposa_14
   ###########
   #    #    #
 ###$$  $  $ #
##    ##  $  #
#  *  ##$#$  #
# * ####    ##
##   ######$##
#   $  ##..  #
# *...*.*.*. #
##$### ##  # #
#    $ ## *$ #
#    $ ## @*.#
#####     *..#
    ###    ..#
      ########

; 0846_mariposa_15
   ###########
   #    #    #
 ###$$  $  $ #
##    ##  $  #
#  *  ##$#$  #
# * ####    ##
##   ######*##
#   $  ##... #
# *...*.*.*. #
##$### ##  # #
#    $ ## *$ #
#   $$ ## @*.#
#####   $ *..#
    ###    ..#
      ########

; 0846_mariposa_16
      ####          
#######  ##         
#.......$ #         
#.#.#$# $ #         
#.$.  ##  #         
#. $ #@ $ #         
#$##.* #  #         
#  #.*### #         
#  #.... .#         
#  ##$#**.##########
# ###              #
# ## .*.###$ #$#$$ #
# #  $ ## #    $   #
# # $ ##  # $$ #$$ #
# #  ##   # $  #   #
# ####    ###$######
#    ########  #    
## $           #    
############  ##    
           ####     

; 0846_mariposa_17
      ####          
#######  ##         
#.......$ #         
#.#.#$# $ #         
#.$.  ##  #         
#. $ #@ $ #         
#$##.* #  #         
#  #.*### #         
#  #.... .#         
#  ##$#**.##########
# ###              #
# ## .*.###$ #$#$$ #
# #  $ ## #    $   #
# # $ ##  # $$ #$$ #
# #  ##   # $  #   #
# ####    ###$######
#  ##########  #    
## $           #    
############   #    
           #####    

; 0846_mariposa_18
  #####            
 ##  #####         
## $ #   ##########
##  $  $  $ ###   #
#  $  #*#   ## $  #
#   ###+###    # ##
## # ......# $ $ ##
 # # *****.. # $  #
##  #*.*.*## $ $  #
#  $#..*..#### #  #
#     ###  ###  ###
### $   $$      #  
  #######  ######  
        ####       

; 0846_mariposa_19
#######   
#     #   
# $**#####
# * *    #
# * **** #
# *    * #
# *    * #
# *****. #
#       @#
##########

; 0846_mariposa_20
          #####
###########.  #
#      ...... #
### #$ #####* #
#  * $$       #
# .* $  * * # #
#@.# $$* ** * #
##.* $  *  *  #
 #.# $$   * * #
 #.* $  *######
 #.# $$  #     
 #.* $   #     
 #.# $$ *#     
 #.#  $  #     
 #.$ #####     
 #   #         
 #####         

; 0846_mariposa_21
#######     ####             
#  #  ### ###  ###           
#*   *  ###  * . ##          
# . * *  ## $ $ * #   ####   
#  # # # #.* #.$. # ###  ### 
# *$*   *#$ . $ * ###  *   ##
# *  *       * .* ##  * * * #
# *# ## .#. ## #$ ##$* # *  #
#  #   * # *        .   * * #
# $####  #  #$###### @ *  * #
##      ###   #    ## ## *  #
 ######## #####     #.   *  #
                    # #***$ #
                    #      ##
                    ######## 

; 0846_mariposa_22
#######     ####             
#  #  ### ###  ###           
#*   *  ###  * . ##          
# . * *  ## $ $ * #   ####   
#  # # # #.* #.$. # ###  ### 
# *$*   *#$ . $ * ###  *   ##
# *  *       * .* ##  * * * #
# *# ## .#. ## #$ ##$* # *  #
#  #   * # *        .   * * #
# $####  #  #$######   *  * #
##      ###   #    ## ## ** #
 ######## #####     #.   *@ #
                    # #***$ #
                    #      ##
                    ######## 

; 0846_mariposa_23
       ######################   
      ##           #.$      ##  
  #####  #######   #### ###$ #  
  #   # ##.   .### ###  ###.$#  
  # $.$ #### $  .#    $  ### #  
### .$. # ## #*##### ## .### ## 
#    * ####. $  ..#  .  .$ # .##
# $$. .   # $   $ # @##$*  #   #
#  ##.$ #   .$   ###     ### $ #
## ######.#*##$$. ## #####    ##
 #  #  $  # #   # #  ##    # $# 
 ## # # $.#   $ $ # $##* ###  # 
  #       #.###   # $.$  ##. ## 
  ########### #####  * *.##$ ## 
                  ## $.  ##  .# 
                   #  .####   # 
                   ##### #.  ## 
                         #####  

; 0846_mariposa_24
          #########  
       ####  $..  #  
    ####  *$.   $ #  
 #### .$*    ### ##  
 # .$*    ####.# ##  
##     ####....#@ #  
# . ####  $ $ .## #  
# * #....$  $ $.# ## 
##$ ##.$$$$ $ $.#  # 
 # . #.$  $ $ $ ## # 
 # $ #. $   $ $  # ##
 ##* ##. $ $$ $$ #  #
  #   #.$  $     ## #
  # * #. $$  $....# #
  ##$ ##. $ ...#### #
   #.  #.   ####    #
   # * #.##.#    ####
   ##$ ### .  ####   
    #.     $###      
    #####   #        
        #####        

