; 0509_simplistic_1
  #####  
###   ###
# $ #   #
# ..$.. #
# $ #   #
###$#####
  #   #  
  # @ #  
  #   #  
  #####  

; 0509_simplistic_2
 #######  
 #  #  ###
##$.#  $ #
# $.   . #
#   ######
### ##  @#
# ..  .$ #
# $$ #.$##
###  #  # 
  ####### 

; 0509_simplistic_3
#######
#. . .#
# $$$ #
#.$@$.#
# $$$ #
#. . .#
#######

; 0509_simplistic_4
 #####  
 #@  #  
##  .###
# $$*$ #
#  #.  #
##  .  #
 ###  ##
   #### 

