; 1010_4x5s_1
####  
# @#  
#. #  
#  ###
# $$ #
#   .#
######

; 1010_4x5s_2
###### 
# ..@# 
#  #$##
#   $ #
##    #
 ######

; 1010_4x5s_3
 ######
 #@  .#
##$# ##
#     #
# $ . #
#######

