; 0249_kisser_1
###########################
#        @  ###.   # #    #
#   # #$$ $ $ #.#..#      #
# $ #$#  ##   #.     ## ###
##  # # $ #$$#..#    ## #  
# $#  #$  #  #.   # ### #  
#   $  $  # $#  #..  .# #  
# $ # $  #    # #.#. ## #  
##$$ $  #   ### #.... # #  
#    ##  ## ### #...  # #  
#  ##  #  $     ####### #  
#       #   ##          #  
#########################  

; 0249_kisser_2
####################
# @          #   * #
#  $ $   # $$$   # #
# # # ####   # #. .#
# $ $ $ $ ## # .. .#
#  #    $    # #.#.#
# # #$# ##$#$$$#. .#
# $ $ $$ $   #.#.#.#
#       #    #... .#
##############... .#
             #######

; 0249_kisser_3
########
#.*.*. #
#.$  #.#
## $.#.#
# $$$$$#
#    @ #
########

; 0249_kisser_4
########
# . .  #
# *.$*$#
# .##@ #
# *$ * #
# $  $ #
#     .#
########

