; 0911_0yzcs_1
     ####     
 #####  ##### 
 #  ##  $@$ # 
 # .   ###. # 
 # ##    # ## 
## #  ##   ###
#  # ####    #
#    ####$#  #
###   ## .# ##
 ## # $  ## # 
 # .###     # 
 #      ##  # 
 #####  ##### 
     ####     

; 0911_0yzcs_2
################################
#                .#   # $    ..#
# ############ $$ #. *  # ##$. #
# #    #      ##  $$ #. $.$ **$#
# # #. $ ####   #. * ##*#. .   #
# #   *###   ##  #   .# $ * *$ #
# # *  #  $#   # ####  .#$###. #
# ## ###$#.  # #    #$#     **##
# #      # $.$. # .$@$ ####    #
# # * *$*####*#  # # * .  ####$#
# # $##  *  * # $$*###*##   # .#
# ##. #..*$.* # ...#   #  $ $ .#
#   # #  *    ..$$.# #   #*.#  #
# #$# #*$*# * *..  #.$   #  ####
# # #.#     * $*$#$#######* .  #
# $   #**.* * *. . #  $   . *$*#
### #.# . #** $  ### ## #**$$  #
#   # # $ $   .#*# $.   * .$.*.#
# *.$  ## # * *$ # # # # $. **.#
#$*# $ .# * *.   # #$# #  *$$ *#
#  ########## #**$. .  ## * .* #
#.   * * * #  # .*$#### $.$$*. #
#  *   # # # $#$.$ .    . . #  #
#*#* * $ $ #  # .***.# ######$##
#    **# . #*$#.$$   $ #   * * #
#***   *.**#  #  #######*# #   #
#  * *     ##   #     $. . # # #
# ** **#*#*$..#  $### ..* $  $ #
#  #       #*####.  ## ##. # $ #
#* * * * # $ ..$  * * $ #$ #$$ #
#    * * * # $   .*   . *. #   #
################################

