; 0328_dh2_1
      #####      
     #     #     
    #  # #  #    
   #  #   #  #   
   # #  *  # #   
  #  # * * #  #  
 #  ##$.#.$##  # 
#  # $  #  $ #  #
# # *  *.* .* # #
#  $ ##. .## $  #
# # *. *.*  * # #
#  # $  #  $ #  #
 #  ##$.#.$##  # 
  #  # * * #  #  
   # #  *  # #   
   #  # @ #  #   
    #  # #  #    
     #     #     
      #####      

; 0328_dh2_2
      ##### 
      #   # 
####### # # 
#    $ $ $# 
# # ..... # 
#  $.$$$.$# 
### .@# . # 
  #$.$$$.$##
  # .....  #
  #$ $ $   #
  # # ######
  #   #     
  #####     

; 0328_dh2_3
 #### #### 
##  ###  ##
#    #  . #
#   * *   #
## * $ * ##
 ## *@* ## 
## * * * ##
#   * *   #
#    #    #
##  ###  ##
 #### #### 

; 0328_dh2_4
          ####      
       ####  ###### 
       #  # .##   # 
       #  $  #  # # 
 #######.*.**#$## # 
 #        #     # ##
## ##$##### $  $#  #
#  # . *  ####  ## #
# ##$* *$ #   #  # #
# #  .....$@$    # #
# #   ##  ######## #
# ##  ##  #        #
#  ######## ########
##          #       
 ############       

; 0328_dh2_5
 #####   ##### 
 #   #####   # 
##     *     ##
# **##$.$##** #
#  . # * # .  #
# ** #$.$# ** #
##   # . #   ##
 ### ## ## ### 
  #  ## ##  #  
  #    $    #  
  #### @ ####  
     #####     

; 0328_dh2_6
         #####   
      ####   #   
   ####    # #   
####  $ # $  ##  
#   .#.$.$.$. #  
# # $.$.$.$.# #  
#  $.$.$.#.$.$## 
##  $.#.$.$.$  # 
 # #.$.$ $.$.# # 
 #  $.$.$.#.$  ##
 ##$.$.#.$.$.$  #
  # #.$.$.$.$ # #
  # .$.$.$.#.   #
  ##  $ # $  ####
   # #  @ ####   
   #   ####      
   #####         

; 0328_dh2_7
###############
#   #     #   #
#  . * *@*  . #
##$##  *$ ##$##
#    #   # $  #
#  #*#####.#  #
# $* #   # .$ #
##   #*.$#   ##
 ###     * ### 
 #  . * * $. # 
 # ## ###.## # 
 #    # #    # 
 ###### ###### 

; 0328_dh2_8
 ##### #####        
##   ###   ######   
#  #  ##      $ ##  
# $$   ##*###  $ ## 
#  # $ #...  #  $ ##
# $# # # *$# ##  $ #
#    $ #...#   #$  #
##  #####.## $    ##
# .#...##.### ##  # 
# *.*....*.. $##### 
# .#. .##.### ##### 
## # ####.#       # 
## $  ###*#$#$$ $ # 
#  ##   $@$    ## # 
# $ $ #$### # $   # 
#     #     ##    # 
################### 

; 0328_dh2_9
#########       
#   #   ####    
#    * ..$ #    
###$## # $ ##   
  #  $  #  @##  
  ##   .###  ###
   ####    # $ #
      #$.#*    #
     ## * . ####
     # $.*.##   
     #     #    
     #######    

; 0328_dh2_10
 ############  
### .*.*.$  ## 
#   * $ * $  ##
#  $.$.*.*.$  #
# $ * *@* * $ #
#  $.*.*.$.$  #
##  $ * $ *   #
 ##  $.*.*. ###
  ###########  

