; 0280_tian_lang_1
######### 
#       # 
# ***** # 
# * . * ##
# *@#$*  #
# *   *  #
# ***** ##
#       # 
######### 

; 0280_tian_lang_2
######### 
#       # 
# ***** # 
# * . * ##
# *$#@*  #
# *   *  #
# ***** ##
#       # 
######### 

; 0280_tian_lang_3
######### 
#       # 
# ***** # 
# *   * ##
# *$#@*  #
# * . *  #
# ***** ##
#       # 
######### 

; 0280_tian_lang_4
######### 
#       # 
# ***** # 
# *   * ##
# *+*$*  #
# *   *  #
# ***** ##
#       # 
######### 

; 0280_tian_lang_5
######### 
#       # 
# ***** ##
# *   *  #
# *+#$*  #
# *   *  #
# ***** ##
#       # 
######### 

; 0280_tian_lang_6
######### 
#       # 
# ***** # 
# * $ * ##
# *.@.*  #
# * $ *  #
# ***** ##
#       # 
######### 

; 0280_tian_lang_7
########## 
#        # 
# ****** # 
# *  . * ##
# *@*# *  #
# *  $ *  #
# ****** ##
#        # 
########## 

; 0280_tian_lang_8
 ################# 
 #       #       # 
 # ***** # ***** # 
## *   * # * . * ##
# $..$#* # * $ .$ #
#  *   * # * # *  #
## ***** # ***** ##
 #       #       # 
 ####### @ ####### 
 #       #       # 
 # ***** # ***** # 
## * # * # *   * ##
# $. $ * # *.$#.$ #
#  * . * # *   *  #
## ***** # ***** ##
 #       #       # 
 ################# 

; 0280_tian_lang_9
  ##########################  
  #            #           #  
 ## ********** # ********* ## 
 #  .        * # *       .  # 
 # $********$* # *$*******$ # 
 ## .        * # *       . ## 
  # ********** # ********* #  
  #            #           #  
 #############   ############ 
 #             #            # 
 # *********** # ********** # 
## *       $ * # * @      * ##
# $* *******.* # *.******$*  #
#  *        .* # *        *  #
## *********** # ********** ##
 #             #            # 
 ############################ 

; 0280_tian_lang_10
 ##################### 
##*                  ##
# $**#*# #*#*# #*#*#  #
# #   * # *   *  *  * #
# *  *  *  *  * * $** #
# # *  *#*  * #*  * # #
# **  * * *  **  *  * #
# #  *  *  *  * *   # #
#  #*#**.**#*#.#*#**$ #
# #  *  *   * # *   # #
# **  * *  *  *  *  * #
# # *  *# *  *#*  * # #
# *  *  **  * * *  ** #
# #   * #  *  *  *  # #
# $**#*#.#*#**.**#*#  #
# #   * *  *  *   * # #
# *  *  **  * *  *  * #
# # *  *# *  *# *  *# #
# **$ * *  *  **  * * #
# *  *  *   * #  *  # #
#  #*#*# #*#*# #*#**+ #
##                   ##
 ##################### 

