; 0995_haiku_1
#############
#. . . .  * #
# $$$$$$* # #
#.$.....* # #
# $.$$$ * # #
#.$.$@* * # #
# $.$** * # #
#.$.    * # #
# *#*##** # #
#           #
#******** ###
#         ###
#############

; 0995_haiku_2
 ########  
 #      #  
 #$**.# ###
##.$.$#   #
# . * ### #
# $ $ $.# #
# .*. . # #
# *  *$$# #
#####@# # #
    #     #
    #######

; 0995_haiku_3
############# 
#          .# 
# ######### ##
#  $ . .   $ #
# . $ $ * *  #
#* * * * * ###
# * * * * ##  
## *.* * ##   
 ##@$ * ##    
  ##   ##     
   #####      

; 0995_haiku_4
########### 
#        .# 
# ####### ##
#  * .   $ #
#   * * $  #
#* * * * ###
# * * * ##  
## * * ##   
 ## @ ##    
  #####     

; 0995_haiku_5
#############
#. . . . .  #
# $$$$$$$.$.#
#.$.. ..$.$$#
# $.$#$.$.$.#
#.$.$+$.$.$ #
# $.$$$.$.$.#
#.$.....$.$ #
# $$$$$$$.$.#
#........   #
# $$$$$$$ ###
# .$. . . #  
###########  

; 0995_haiku_6
#################
#. . . . . . .  #
# $$$$$$$$$$$.$.#
#.$.........$.$$#
# $.$$$$$$$.$.$.#
#.$.$.....$.$.$ #
# $.$.$$$.$.$.$.#
#.$.$.$+ *$.$.$ #
# $.$.$$$.$.$.$.#
#.$.$..... *$.$ #
# $.$$$$$$$.$.$.#
#.$......... *$ #
# $$$$$$$$$$$.$.#
#............   #
# $$$$$$$$$$$ ###
# .$. . . . . #  
###############  

; 0995_haiku_7
#################
#. . . . . . .  #
# $$$$$$$$$$$.$.#
#.$.........$.$$#
# $.$$$$$$$.$.$.#
#.$.$..#..$.$.$ #
# $.$.$ $.$.$.$.#
#.$.$.$+$.$.$.$ #
# $.$.$$$.$.$.$.#
#.$.$.....$.$.$ #
# $# $$$$$$.$.$.#
#.$.........$.$ #
# $$$$$$$$$$$.$.#
#............   #
# $$$$$$$$$$$ ###
# .$. . . . . #  
###############  

; 0995_haiku_8
#################
#. . . . . . .$ #
# $$$$$$$$$$$.$.#
#.$.........$.$ #
# $.$$$$$$$.$.$.#
#.$.$.....$.$.$ #
# $.$.$$$.$.$.$.#
#.$.$.$+$.$.$.$ #
# $.$.$$$.$.$.$.#
#.$.$.....$.$.$ #
# $.$$$$$$$.$.$.#
#.$.........$.$ #
# $$$$$$$$$$$.$.#
#............   #
#$$$$$$$$$$$$ ###
# . . . . . . #  
###############  

; 0995_haiku_9
#############
######## .  #
######## .$.#
#######  *$ #
######  *.$.#
#### + *$.$$#
###  $  *.$.#
##  *.*  *$ #
#  *$$$* .$.#
# $.....*   #
#.$$$$$$$.###
#  . * .  ###
#############

; 0995_haiku_10
     #####     
    ##   ##    
   ##  *  ##   
  ##  * *  ##  
 ##  * * *  ## 
##  * * * *  ##
#  * * * * *  #
# *$*.* *$*.* #
# * * *** * * #
# * *     * * #
# * ******* * #
# *    @    * #
# *********** #
#             #
###############

; 0995_haiku_11
     #####     
    ##   ##    
   ##  *  ##   
  ##  * *  ##  
 ##  * * *  ## 
##  * * * *  ##
#  * * * * *  #
# ***.* *** * #
# * * *** * * #
# * $     * * #
# * ******* * #
# *    @    * #
# ########### #
#             #
###############
               

; 0995_haiku_12
   #####   
  ##   ##  
 ##  *  ## 
##  * *  ##
#  * * *  #
# *$* *.* #
# * *** * #
# *  @  * #
# ******* #
#         #
###########

; 0995_haiku_13
###########   
#    .    #   
# ### ### ####
#.   *. .$*@ #
### $* * .$$ #
  ##  $*$..$ #
   ##     * ##
    #####  ## 
        ####  

; 0995_haiku_14
  ####  
  #  #  
### $###
#@$.$  #
# #.*  #
# #  ###
# #  #  
#  . #  
######  

; 0995_haiku_15
##########   
#        #   
#   **** #   
#****  * #   
#.     * #   
#***** * #   
#    * * ####
#### * *    #
   # * *****#
   # *    $@#
   # *  ****#
   # ****   #
   #        #
   ##########

; 0995_haiku_16
##############  
#            #  
#  **#######.###
## .$  $ $ $ * #
 #$.$*..+..* # #
 # .   $ $ $ . #
 #$**######### #
 #             #
 ###############

; 0995_haiku_17
 ##########
##      @ #
#  **#### #
#   *   # #
### **# # #
  # * # # #
  # * # # #
  # * * # #
  # * # # #
  # * # # #
  # * # # #
  # * * # #
  # * # # #
  # * # # #
  #$* # # #
  # .   # #
  # #*### #
  #       #
  #########

; 0995_haiku_18
######################
####   ###############
#  # # ##  ###########
#      ##     .#######
# .## ###  #.#.$.$  ##
##*##$#### #.#.$.$..##
##.   #### #.*.$. ..##
##.#$$  ## # #### #$##
##.# .*. # $ #    $ ##
##.$   $   $##$$ $$ ##
##.####### .# $  #  ##
##  #######...#  $  ##
##$ #   ####$* ###  ##
##.....*.#    $###$###
# $$ $ $ #   # ###   #
#  ####$ $$$#      # #
#  #### @#    ####   #
######################

; 0995_haiku_19
#####################
####   ##############
#  # # ##  ##########
#      ##   . .######
# .## ###  #.#.$.$  #
##*##$#### #.#.$.$..#
##.   #### #.*.$. ..#
##.#$$  ## # #### #$#
##.# .*. # $ #    $ #
##.$   $   $##$$ $$ #
##.#######  # $  #  #
##  #######...#  $  #
##$ #   ####$* ###  #
##.....*.#    $###$##
# $$ $ $ #   # ###  #
#  ####$ $$$#       #
#  #### @#    ####  #
#####################

; 0995_haiku_20
#####################
# . $   @##      #  #
# * **#.#  $ .*#    #
# $#$ $$#$.* $ ###  #
# . .. . $ ##*.$ ** #
# $ .$   ..$     .  #
#####################

