; 0064_cubes_tubes_1
#############
#############
##         ##
## ### ### ##
## #   # # ##
## # $.$ # ##
##   .@.   ##
## # $.$ # ##
## # #   # ##
## ### ### ##
##         ##
#############
#############

; 0064_cubes_tubes_2
#############
#############
##    #    ##
## ## # ## ##
## #  @  # ##
## # .$. # ##
##   $#$   ##
## # .$. # ##
## #     # ##
## ## # ## ##
##    #    ##
#############
#############

; 0064_cubes_tubes_3
#############
#           #
# #### #### #
# #       # #
# # $ . $ # #
# #  .$.  # #
#   .$@$.   #
# #  .$.  # #
# # $ . $ # #
# #       # #
# #### #### #
#           #
#############

; 0064_cubes_tubes_4
#############
#  ######   #
#           #
#  ## $### ##
## .#   #. ##
#   # $ #   #
# #   #   # #
#   # $ #   #
## .# @ #. ##
## ###$###  #
#           #
#   ######  #
#############

; 0064_cubes_tubes_5
#############
##. # # # .##
#.  $   $  .#
#  .#   #.  #
##$###$###$##
#   #   #   #
##  $ @ $  ##
#   #   #   #
##$###$###$##
#  .#   #.  #
#.  $   $  .#
##. # # # .##
#############

; 0064_cubes_tubes_6
#############
#  #     #  #
#  # #$# #  #
#           #
## # # # # ##
## # #.# # ##
## # #.# # ##
## # #.# # ##
## # #.# # ##
## # #.# # ##
##$#$###$#$##
##    @    ##
#############

; 0064_cubes_tubes_7
#############
#           #
# $#$ # $#$ #
# $       $ #
### # # # ###
# # #.#.# # #
# # #.#.# # #
# # #.#.# # #
# # #.#.# # #
# # #.#.# # #
# #$#$#$#$# #
#     @     #
#############

; 0064_cubes_tubes_8
#############
#           #
# $#$# #$#$ #
#  $     $  #
##$# $ $ #$##
#  #.#.#.#  #
#  #.#.#.#  #
#  #.#.#.#  #
#  #.#.#.#  #
#  #.#.#.#  #
##$#$#$#$#$##
#     @     #
#############

; 0064_cubes_tubes_9
#############
#           #
# # # # # # #
# $ $ $ $ $ #
# # #.#.# # #
# # #.#.# # #
###.# # #.###
# # #.#.# # #
# # #.#.# # #
# $ $ $ $ $ #
# # # # # # #
#     @     #
#############

; 0064_cubes_tubes_10
#############
#           #
# # # # # # #
# $ $ $ $ $ #
# #.#.#.#.# #
# $ #.#.# $ #
### #.#.# ###
# $ #.#.# $ #
# #.#.#.#.# #
# $ $ $ $ $ #
# # # # # # #
#     @     #
#############

; 0064_cubes_tubes_11
#############
#           #
# # # # # # #
# $ $ $ $ $ #
# #.#.#.#.# #
# $.#.#.#.$ #
### $ # $ ###
# $.#.#.#.$ #
# #.#.#.#.# #
# $ $ $ $ $ #
# # # # # # #
#     @     #
#############

; 0064_cubes_tubes_12
#############
#           #
# #$# # #$# #
# $       $ #
# # # # # # #
#.# $ $ $ #.#
#.# # # # #.#
#.# $ $ $ #.#
#.# # # # #.#
#.# # # # #.#
#.#$#$#$#$#.#
#.#   @   #.#
#############

; 0064_cubes_tubes_13
#############
#.#   #   #.#
#.# # $ # #.#
#.# $ # $ #.#
#.#$# # #$#.#
#     #     #
#$#$ $@$ $#$#
#     #     #
#.#$# # #$#.#
#.# $ # $ #.#
#.# # $ # #.#
#.#   #   #.#
#############

; 0064_cubes_tubes_14
#############
#.  $   $  .#
#.# # $   #.#
#.# $ $ $ #.#
#.# #######.#
#    $ #    #
# #$ #@# $# #
#    # $    #
#.####### #.#
#.# $ $ $ #.#
#.#   $ # #.#
#.  $   $  .#
#############

; 0064_cubes_tubes_15
#############
# . .   . . #
#.###$#$###.#
# #   #   # #
#.# $ $ $ #.#
# $   #   $ #
# ##$###$## #
# $   #   $ #
#.# $ $ $ #.#
# #   #   # #
#.###$#$###.#
# . . @ . . #
#############

; 0064_cubes_tubes_16
#############
# ...   ... #
#.#$#$#$#$#.#
#.$   #   $.#
#.# $ $ $ #.#
# $   #   $ #
# ##$###$## #
# $   #   $ #
#.# $ $ $ #.#
#.$   #   $.#
#.#$#$#$#$#.#
# ... @ ... #
#############

; 0064_cubes_tubes_17
#############
#    ...    #
# # ##### # #
#   $ # $   #
# #$  $  $# #
#.#   #   #.#
#.##$###$##.#
#.#   #   #.#
# #$  $@ $# #
#   $ # $   #
# # ##### # #
#    ...    #
#############

; 0064_cubes_tubes_18
#############
#   ..$..   #
# # ##### # #
#   $ # $   #
#.#$  $  $#.#
#.#   #   #.#
#$##$###$##$#
#.#   #   #.#
#.#$  $@ $#.#
#   $ # $   #
# # ##### # #
#   ..$..   #
#############

; 0064_cubes_tubes_19
#############
##... $ ...##
#.### #$###.#
#.#   $   #.#
#.# $   $ #.#
# $  $$$    #
#$#$ $@$ $#$#
#    $$$  $ #
#.# $   $ #.#
#.#   $   #.#
#.###$# ###.#
##... $ ...##
#############

; 0064_cubes_tubes_20
#############
###   #   ###
#  $  #  $  #
#  $  #  $  #
##$#$###$#$##
## $  #  $ ##
## $  #  $ ##
## ##   ## ##
#  ### ### ##
#  ..# #..  #
#. .. @ .. .#
#.   # #   .#
#############

