Festival 3.1 solution file
===========================
Collection: ../sokoban_core/levels/examples/lvl_1.txt

Level 1

 #######    ########
 #     ######  @   #
 # $#$  #  ## #$#$ #
 #$   $ # $##   #  #
 # $#$  #  ####$#$ #
##$    ### ##      #
#  $        # #$#$ #
#   $  $ $         #
##### ##### ########
    #$#   #$#       
   ## ## ## ##      
   #   # #   #      
 ###   # #   ###    
 #.....# #.....#    
 #.....# #.....#    
 ####### #######    

