; 1002_cyclic_1
######
#    #
#@ * #
######

; 1002_cyclic_2
####  
#  ###
# *  #
# @* #
###  #
  #  #
  #  #
  ####

; 1002_cyclic_3
#####   
#@  ####
# #    #
#   *# #
####   #
   #####

; 1002_cyclic_4
   ##### 
####   ##
# *  #  #
# #*  # #
#  @#   #
#########

; 1002_cyclic_5
####  #####
#  ####   #
#         #
#  ##### ##
## ###@# ##
#     *#  #
#   #     #
########  #
       ####

