; 1019_4xn_fibo-likes_1
######
#    #
#+** #
#  $ #
##   #
######

; 1019_4xn_fibo-likes_2
#######
#     #
#+*** #
#   $ #
###   #
#######

; 1019_4xn_fibo-likes_3
########
#      #
#+**** #
#    $ #
####   #
########

; 1019_4xn_fibo-likes_4
#########
#       #
#+***** #
#     $ #
#####   #
#########

; 1019_4xn_fibo-likes_5
##########
#        #
#+****** #
#      $ #
######   #
##########

; 1019_4xn_fibo-likes_6
###########
#         #
#+******* #
#       $ #
#######   #
###########

