; 0842_fibo_bibo_1
 #####  #######
 # + #  #     #
 #$.$#  # .## #
 # * #  # * # #
 # * #### * # #
 # * ## * * # #
## *  # # * # #
#  *  # * * * #
#  *  # *** * #
##  #     $   #
 ########  ####
        ####   

; 0842_fibo_bibo_2
 #####  #######
 # + #  #     #
 #$.$#  # .## #
 # * #  # * # #
 # * #### * # #
 # * ## * * # #
 # * ## # * # #
 # * ## # * # #
## *  # # * # #
#  *  # * * * #
#  *  # *** * #
##  #     $   #
 ########  ####
        ####   

; 0842_fibo_bibo_3
 #####  #######
 # + #  #     #
 #$.$#  # .## #
 # * #  # * # #
 # * #### * # #
 # * ## * * # #
 # * ## # * # #
 # * ## # * # #
 # * ## # * # #
 # * ## # * # #
## *  # # * # #
#  *  # * * * #
#  *  # *** * #
##  #     $   #
 ########  ####
        ####   

; 0842_fibo_bibo_4
 #####  #######
 # + #  #     #
 #$.$#  # .## #
 # * #  # * # #
 # * #### * # #
 # * ## * * # #
 # * ## # * # #
 # * ## # * # #
 # * ## # * # #
 # * ## # * # #
 # * ## # * # #
 # * ## # * # #
## *  # # * # #
#  *  # * * * #
#  *  # *** * #
##  #     $   #
 ########  ####
        ####   

; 0842_fibo_bibo_5
 #####  #######
 # + #  #     #
 #$.$#  # .## #
 # * #  # * # #
 # * #### * # #
 # * ## * * # #
 # * ## # * # #
 # * ## # * # #
 # * ## # * # #
 # * ## # * # #
 # * ## # * # #
 # * ## # * # #
 # * ## # * # #
 # * ## # * # #
## *  # # * # #
#  *  # * * * #
#  *  # *** * #
##  #     $   #
 ########  ####
        ####   

