; 0318_startwithendposition_1
 ####     
 #  #     
##  ######
#  *#@*  #
#    **  #
##  #  ###
 ####  #  
    ####  

; 0318_startwithendposition_2
    ####  
    #  #  
#####  #  
##   **###
#  **@*  #
#    **  #
###  * ###
  ##   #  
   #####  

; 0318_startwithendposition_3
     ####  
    ##  #  
#####   #  
#     * #  
#  **** ## 
##  *@*  ##
 ## ****  #
  # *     #
  #   #####
  #  ##    
  ####     

; 0318_startwithendposition_4
   ####  
####  ###
#       #
#  ***  #
## *   ##
 # ***  #
 # *@*  #
 #  *  ##
 ####### 

; 0318_startwithendposition_5
 ####  
 #  ###
##    #
#  ** #
#  *@##
##  ## 
 ####  

; 0318_startwithendposition_6
     ##########    
     #    #   #### 
     #   *   *#  # 
     ## **##     ##
  #####  * ###**  #
  #     #* #      #
### * * *@* * * ###
#      # *#     #  
#  **### *  #####  
##     ##** ##     
 #  #*   *   #     
 ####   #    #     
    ##########     

; 0318_startwithendposition_7
####   
#  ####
#  #  #
#  *  #
##**  #
#@*   #
#######

; 0318_startwithendposition_8
  ####   
###  ####
#    #  #
#  * *  #
###***  #
  #@*   #
  #######

; 0318_startwithendposition_9
    ####   
#####  ####
#  *   #  #
#    * *  #
## *#***  #
 #  #@*   #
 ##########

; 0318_startwithendposition_10
   #### 
   #  # 
   #  ##
#### * #
#    * #
# *    #
# * *###
###*  # 
 #@*  # 
 ###### 

; 0318_startwithendposition_11
        ####
  #######  #
  #  #     #
  # * *** *#
###  **@#  #
#   * *#  *#
# #    * * #
#  * * *   #
####*## #  #
  # * *   ##
  #      ## 
  ########  

; 0318_startwithendposition_12
        ####  
    #####  #  
    #      #  
    # ### *## 
 #### # * * ##
 #    #  * *@#
 # #  # # * ##
 # ##      ## 
## ### #####  
# **  * #     
#       #     
#  ######     
####          

