; 0521_faux_pas_1
  ######           
  #    #########   
### $# #       #   
# $ $  # $$ $$ #   
# ##$ $#  $$   #   
# ##   ##  #####   
# ##$$ ### ###     
# ##   ### ####    
# ##$$ ###....#####
# ##    ##.#......#
# ##$$$   ....#####
# ##   $# ....#    
#   $     ..#.#    
####   ########    
   ## $#           
    #$ #           
    #@##           
    ###            

