; 0936_my_levels_1
#######
##@ * #
#     #
#.$#$.#
#     #
# *  ##
#######

