; 0707_chaotic_catalysts_01_1
##########
#        #
# $$..$* #
#@.$.#.$ #
# $.$.$. #
# .$..$$ #
##$$.$.. #
# $.$.$.##
#        #
##########

; 0707_chaotic_catalysts_01_2
##########
#  #     #
# $*.$.$@#
# .$.*#. #
# $.*.$. #
# $..$$$ #
# $$.$.$ #
# .$...$ #
#    #   #
##########

; 0707_chaotic_catalysts_01_3
##########
#        #
# $$$.$. #
# .#..$. #
# $$$*.$##
# ...$.. #
##.$+.$$ #
# .$$$.$ #
#        #
##########

; 0707_chaotic_catalysts_01_4
##########
#        #
# .$..$$ #
# #.$.$. #
# $.$.$*##
# *$*$.. #
# ..$.$$ #
# $$..$. #
#@ #     #
##########

; 0707_chaotic_catalysts_01_5
##########
#   #    #
# $...$. #
# *$.$*$ #
# $@$.$. #
# .$.#.$ #
# $.$.$. #
# .$.$.$ #
#  #     #
##########

; 0707_chaotic_catalysts_01_6
##########
#    #   #
# .$.*$$ #
##*$.... #
# .$.$$$ #
# ..$..$ #
# $$*#.$ #
# $.$.$. #
#@       #
##########

; 0707_chaotic_catalysts_01_7
##########
#        #
# $$.$.$ #
# ..#*$$ #
# $.*.$.@#
# ..$...##
##*.**$. #
# $$$.$$ #
#        #
##########

; 0707_chaotic_catalysts_01_8
##########
#      @ #
# *$$.$. #
# $..$*.##
# $$..$. #
# .$.$.$ #
##$.*#$. #
# $.$.$. #
#        #
##########

; 0707_chaotic_catalysts_01_9
##########
#  #     #
#@$..*$$ #
# .$$*.. #
# $..#*$ #
# .$...$ #
# .*$.$* #
# $$.$.$##
#        #
##########

; 0707_chaotic_catalysts_01_10
##########
#        #
# .$.$$$ #
# $.$... #
# $$.$.$ #
# ..*#.. #
# $$$.$*##
# ..*$.$ #
#  #@    #
##########

; 0707_chaotic_catalysts_01_11
##########
#  #     #
# ...*$. #
# $$.$..##
# .$.$$. #
# $$...$ #
# .*$*$* #
# $$.$.$ #
#    #@  #
##########

; 0707_chaotic_catalysts_01_12
##########
#     @  #
# .$.$.$ #
# $$.$$*##
# $...$. #
# *$$..$ #
##*.*$.$ #
# ..$..$ #
#    #   #
##########

; 0707_chaotic_catalysts_01_13
##########
#     #  #
# $.*.*. #
# *$*$*$ #
# $+.... #
# ..$.$$ #
##$$$*$. #
# ..$.$$ #
#   #    #
##########

