; 0315_squared_1
#######
# . * #
#.*$ .#
# $ $ #
#*$ .*#
#@* * #
#######

; 0315_squared_2
#######
#+$. .#
# *$$ #
#* $ *#
#  $. #
#* . *#
#######

; 0315_squared_3
#######
#@*.  #
#*$$. #
#.$ $*#
# .$ .#
#  ** #
#######

; 0315_squared_4
#######
#.* *.#
#     #
#$*$* #
# $  $#
#.* *+#
#######

; 0315_squared_5
#######
# ..$@#
#.*$$$#
#.$ $.#
#  $..#
# $.* #
#######

; 0315_squared_6
#######
#.*   #
#.* *$#
# $   #
#$*$*.#
#@$ ..#
#######

; 0315_squared_7
#######
#@**. #
#*$  .#
# $$$$#
#.$  .#
# ..* #
#######

; 0315_squared_8
#######
# .* .#
#.$$  #
#.$ $.#
#$$$ *#
#+$.. #
#######

; 0315_squared_9
#######
#.* . #
#.$  .#
# $ $$#
#*$$$.#
#@* ..#
#######

; 0315_squared_10
#######
#..*  #
#.$   #
#.$$ *#
#$ $$.#
#@$..*#
#######

; 0315_squared_11
#######
#..$ .#
#.$ * #
# $$ $#
#$* $.#
#+$ ..#
#######

; 0315_squared_12
#######
#...*.#
#  $ $#
# $ $ #
#$$$$ #
#+*...#
#######

; 0315_squared_13
#######
#..$ .#
#.* $ #
#  $ $#
# $$*.#
#.$@*.#
#######

; 0315_squared_14
#######
#+* ..#
#$$*$$#
# $   #
# $. $#
#..$..#
#######

; 0315_squared_15
#######
#.. ..#
# $$$ #
#*  $.#
#  $$$#
#*. *+#
#######

; 0315_squared_16
#######
# . $@#
#***$$#
# * * #
#  .*.#
#   * #
#######

; 0315_squared_17
#######
#*. $@#
#.$*$$#
# * * #
#  . .#
#   **#
#######

; 0315_squared_18
#######
#* * .#
#.  $.#
#  * $#
#* $$.#
#* *@*#
#######

; 0315_squared_19
#######
# ..*@#
#* $$*#
# $.$ #
#. $$.#
# **. #
#######

; 0315_squared_20
#######
#.. $ #
#.* * #
# $.  #
#$*$**#
#@$ .*#
#######

; 0315_squared_21
#######
#.. *@#
#* $$*#
# $.$ #
#. $$.#
# * .*#
#######

; 0315_squared_22
#######
#. $ *#
#* $ .#
# .*. #
#*$$$.#
#*@$ .#
#######

; 0315_squared_23
#######
#+**.*#
#$ $  #
# $*$ #
# $  $#
#.*...#
#######

; 0315_squared_24
#######
#*. $+#
#..$$$#
#$ .$ #
# $$*.#
#.  .*#
#######

; 0315_squared_25
#######
#**.$@#
#. $$$#
#.$.$.#
#  $$.#
# $...#
#######

; 0315_squared_26
#######
#.    #
# $*. #
# * . #
#$**$ #
#@$  .#
#######

; 0315_squared_27
#######
# .+. #
# $*$ #
# $ $ #
# $.$ #
# .*. #
#######

; 0315_squared_28
#######
# .   #
#.*@*$#
# $$  #
#$* *.#
#   . #
#######

; 0315_squared_29
#######
# .$. #
#.$$ .#
#@$ $ #
#.$$ .#
# .$. #
#######

; 0315_squared_30
#######
#@*.  #
#*$$  #
#.$ $.#
# $$ .#
#  .. #
#######

; 0315_squared_31
#######
#+$.  #
#$*$$ #
#.$ $.#
#   . #
#  * .#
#######

; 0315_squared_32
#######
#. . .#
# $$$ #
#.$@$.#
# $$$ #
#. . .#
#######

; 0315_squared_33
#######
# .$ .#
#.. $ #
#$$$ $#
# @$..#
#. $. #
#######

; 0315_squared_34
#######
#. *  #
# $$. #
#.  $.#
#$. $$#
#  * +#
#######

; 0315_squared_35
#######
#. . .#
#$$+$$#
#  $  #
# $*$ #
#. . .#
#######

; 0315_squared_36
#######
# .$ .#
#.  * #
#$ $$ #
# *@$.#
#. $. #
#######

; 0315_squared_37
#######
#.  $+#
#$$.$$#
# * . #
# $.  #
#. $ .#
#######

; 0315_squared_38
#######
#..@..#
#  $  #
#$$$$$#
# $ $ #
#.. ..#
#######

; 0315_squared_39
#######
#. . .#
#$ $ $#
# * . #
#$  $$#
#. .$+#
#######

; 0315_squared_40
#######
#..$ .#
#. $$ #
# @$  #
#$$$$.#
#.  ..#
#######

; 0315_squared_41
#######
#+*   #
#**$$ #
# $ $ #
#   ..#
#  $..#
#######

; 0315_squared_42
#######
#..   #
#* $* #
# $ $@#
# * $.#
#   *.#
#######

; 0315_squared_43
#######
# ... #
#  $$ #
#.  $.#
# $$$$#
# .*.@#
#######

