; 0903_advanced_1
 ##### 
## . ##
#  $  #
#.$*$.#
#  $  #
## @ ##
 ##.## 
  ###  

; 0903_advanced_2
#######
#   . #
#.$#$ #
#@ *  #
# $#$.#
# .   #
#######

; 0903_advanced_3
   ####
  ## @#
### $ #
# .$. #
# $#$ #
# .$. #
##   .#
 ######

; 0903_advanced_4
#####  
#. .#  
#.$ ###
#  .  #
## ## #
# $   #
# $ $##
#@   # 
###### 

; 0903_advanced_5
 #####  
 #.  #  
## #$###
#  . . #
#  #$# #
# *  $ #
##  @###
 #####  

; 0903_advanced_6
 ####### 
##     ##
# $*$*. #
#  .@.  #
##.*$*$ #
 #     ##
 ####### 

; 0903_advanced_7
 ####  
## @###
# $ $ #
#.$.$.#
# $ $ #
#. . .#
#######

; 0903_advanced_8
 ####   
##  ####
#      #
# ****+#
##   $ #
 #   ###
 #####  

; 0903_advanced_9
#######
#@ .. #
#.$$  #
#$ #$ #
#.$$  #
#  ..##
###### 

; 0903_advanced_10
####### 
#     # 
#.$$. # 
#$.#$@# 
# *$ .# 
#   . # 
####### 

