; 0279_the_cantrip_collection_2_1
   ####     
  ##  #     
  # . #     
  #   ##    
#### . #####
#  # #   $@#
# $  * #$$ #
#  . #$.. ##
##*# . $ ## 
 #   #####  
 #####      

; 0279_the_cantrip_collection_2_2
###########
#    .  $@#
#  *# #*  #
##  *.. ###
 #$ #.#$ # 
 #  $.$  # 
 #  ###  # 
 #### #### 

; 0279_the_cantrip_collection_2_3
  #####  
 ##   #  
 #  #$###
 # . *  #
 # ..*  #
###. .# #
#@$$$ $ #
#   #####
#####    

; 0279_the_cantrip_collection_2_4
    #####   
 ####   #   
 # $@*  ####
## ### ##  #
# $.#  #.  #
#    $ $   #
# .* #. ** #
###  #   ###
  ########  

; 0279_the_cantrip_collection_2_5
   #####  
   #   #  
####$$ ###
# $ .# * #
#  #. .  #
#  . *#$ #
##. #.$@##
 ##$   ## 
  #   ##  
  #####   

; 0279_the_cantrip_collection_2_6
 ########## 
##   ##  .# 
# $  ##*#.##
#  $   .*. #
#   $ #.$. #
### $ #*#  #
  ###$#   ##
    #  # ## 
    ## @ #  
     #####  

; 0279_the_cantrip_collection_2_7
   ##### 
####   ##
#  #$   #
# . .$. #
# .$* * #
## .*.$##
 # $#$ # 
 ## @  # 
  ###### 

; 0279_the_cantrip_collection_2_8
      #####
#######   #
#  #@$    #
# . *$#$$ #
# *.  #  ##
##  # $ ## 
 ##.**# .# 
  #.     # 
  ##  #  # 
   ####### 

; 0279_the_cantrip_collection_2_9
   #####   
  ##   ####
 ##  #$$  #
 #  #   *@#
 # ##.#$###
##  ... ###
#  .#*#   #
#   $ $ # #
#### .  $ #
   ###  ###
     ####  

; 0279_the_cantrip_collection_2_10
#####      
#   ####   
#    $ #   
##  $# ##  
 # #..* ## 
 #.*. # @# 
 ##$# *$## 
  #   $. ##
  ##   $. #
   ####   #
      #####

; 0279_the_cantrip_collection_2_11
##########  
#   #@   #  
#   ***# ###
## #.*.#$  #
 # # *.    #
 #  #.### ##
 #  #     # 
 #  $ $#  # 
 #### $ ### 
    #   #   
    #####   

; 0279_the_cantrip_collection_2_12
########## 
#   ##   ##
#    $    #
##$## ... #
#  $ #*#.##
#    *+#.# 
#  $$##  # 
#  #  #$ # 
####   $ # 
   # .#### 
   ####    

; 0279_the_cantrip_collection_2_13
 ########
 #      #
##$* * $#
# $. .#.#
#@$.#. .#
##$*$*  #
 #      #
 ########

