; 0063_demons_diamonds_1
     ###     ###     
    ## ##   ## ##    
   ##   ## ##   ##   
  ##  $  ###     ##  
 ##  *.$  #  **$  ## 
##  $.$.$ . $. .$  ##
#..* * * *+.$.* $...#
##  $.$.$ .  * *   ##
 ##  *.$  #  *$*  ## 
  ##  $  ## $   $ #  
   ##   #####   ###  
    ## ##   ## ##    
     ###     ###     

; 0063_demons_diamonds_2
     ###     ###     
    ## ##   ## ##    
   ##   ## ##   ##   
  ##  $  ###  .  ##  
 ##  $ $  #  . .  ## 
##  $ $ $   . . .  ##
#  $ $#$ $@. .#. .  #
##  $ $ $   . . .  ##
 ##  $ $  #  . .  ## 
  ##  $  ###  .  ##  
   ##   ## ##   ##   
    ## ##   ## ##    
     ###     ###     

; 0063_demons_diamonds_3
     ###     ###     
    ## ##   ## ##    
   ##   ## ##   ##   
  ##  $  ###  .  ##  
 ##  $ $  #  . .  ## 
##  $ $ $   . . .  ##
#  $#$#$#$@.#.#.#.  #
##  $ $ $   . . .  ##
 ##  $ $  #  . .  ## 
  ##  $  ###  .  ##  
   ##   ## ##   ##   
    ## ##   ## ##    
     ###     ###     

; 0063_demons_diamonds_4
     ###     ###     
    ## ##   ## ##    
   ##   ## ##   ##   
  ##  $  ###  .  ##  
 ##  $#$  #  .#.  ## 
##  $ $ $   . . .  ##
#  $ $#$ $@.#.#.#.  #
#   $ $ $   . . .  ##
###  $#$  #  .#.  ## 
  ##  $  ###  .  ##  
   ##   ## ##   ##   
    ## ##   ## ##    
     ###     ###     

; 0063_demons_diamonds_5
     ###     ###     
    ## ##   ## ##    
   ##   ## ##   ##   
  ##  $  ###  .  ##  
 ##  $ .  #  .#$  ## 
##  $ # .   . # $  ##
#  $ $#.#.#.#.#$ $  #
##  $ # . @ . # $  ##
 ##  $#.  #  . $  ## 
  ##  .  ###  $  ##  
   ##   ## ##   ##   
    ## ##   ## ##    
     ###     ###     

; 0063_demons_diamonds_6
     ###     ###     
    ## ##   ## ##    
   ##   ## ##   ##   
  ##  $  ###     ##  
 ##  $ $  #  ...  ## 
##  $ $ $   .#.#.  ##
#  $ $#$ $@ .#.#.   #
##  $ $ $    .#.   ##
 ##  $ $  #  ...  ## 
  ##  $  ###.   .##  
   ##   ## ##   ##   
    ## ##   ## ##    
     ###     ###     

; 0063_demons_diamonds_7
     ###     ###     
    ## ##   ## ##    
   ##   ## ##   ##   
  ##     ###     ##  
 ##  $$$  #  ...  ## 
##  $   $   .# #.  ##
#   $ $ $ @ .#.#.   #
##   $ $     .#.   ##
 ##  $$$  #  ...  ## 
  # $   $ # .   . #  
  ###   #####   ###  
    ## ##   ## ##    
     ###     ###     

; 0063_demons_diamonds_8
     ###     ###     
    ## ##   ## ##    
   ##   #####   ###  
  ##     ##   #   #  
 ##  $$$  #  ...  ## 
##  $   $   .###.  ##
#  #$ $ $#@ .#.#.   #
##   $ $    #. .#  ##
 ##  $$$  #  ...   # 
  # $   $ # .   . ## 
  ###   #####   ###  
    ## ##   ## ##    
     ###     ###     

; 0063_demons_diamonds_9
     ###########      
    ## ##   ## ###    
   ##   ##   #   ###  
  ##     #   # #   #  
 ##  $$$  #  ... # #  
##  $   $   .###.  ## 
#  #$ $ $###+#.#.#  ##
##   $ $  #  . .     #
 ##  $$$  # #...     #
  # $   $ # .   . ####
  ###   #####   ###   
    ## ##   ## ##     
     ###     ###      

; 0063_demons_diamonds_10
  ####### ####### #######  
 ##     ###     ###     ## 
### $$$   # $$$ #   $$$ ###
#  $   $#  $   $  #$   $  #
# #$ $ $  #$ $ $#  $ $ $# #
#   $ $ #   $@$   # $ $   #
# # $$$   # $$$ #   $$$ # #
#  $   $# #$   $# #$   $  #
# ##### # # ### # # ##### #
# ###.       .       .### #
# ## .       .       . ## #
# # . .     . .     . . # #
#  .....   .....   .....  #
#  ..#..   ..#..   ..#..  #
#  .###.   .###.   .###.  #
# ### ##   ## ##   ## ### #
###    #####   #####    ###

; 0063_demons_diamonds_11
  ####### ####### #######  
 ##     ###     ###     ## 
##  $$$   # $$$ #   $$$  ##
#  $   $#  $ # $  #$   $  #
# #$ $ $  #$ $ $#  $ $ $# #
#   $ $ #   $@$   # $ $   #
# # $$$     $$$     $$$ # #
#  $   $# #$   $# #$   $  #
####### # # ### # # #######
#####.# #   #.#   # #.#####
# ###.# #####.##### #.### #
#  #. .     . .     . .#  #
#  .....   .....   .....  #
#  ..#..   ..#..   ..#..  #
#  .###.   .###.   .###.  #
# ### ##   ## ##   ## ### #
###    #####   #####    ###

; 0063_demons_diamonds_12
  ####### ####### #######  
 ##     ###     ###     ## 
##  $$$   # $$$ #   $$$  ##
#  $   $#  $ # $  #$   $  #
# #$ $ $  #$ $ $#  $ $ $# #
#   $ $ #   $@$   # $ $   #
# # $$$     $$$     $$$ # #
#  $   $# #$   $# #$   $  #
####### # # # # # # #######
#####.#     #.#     #.#####
# ###.#######.#######.### #
#  #. .     . .     . .#  #
#  .....   .....   .....  #
#  ..#..   ..#..   ..#..  #
#  .###.   .###.   .###.  #
# ### ##   ## ##   ## ### #
###    #####   #####    ###

; 0063_demons_diamonds_13
 ################# 
##  #    .    #  ##
#     # *$* #     #
#   $# * . * #$   #
## $  .$.$.$.  $ ##
#  # # .$.$. # #  #
# # . # *$* # . # #
#  *$. $   $ .$*  #
# * .$* #.# *$. * #
#.$.$.$ .@. $.$.$.#
# * .$* #.# *$. * #
#  *$. $   $ .$*  #
# # . # *$* # . # #
#  # # .$.$. # #  #
## $  .$.$.$.  $ ##
#   $# * . * #$   #
#     # *$* #     #
##  #    .    #  ##
 ################# 

; 0063_demons_diamonds_14
     ####          
    ##  ##         
   ## $  #####     
  ## $ $  #  ###   
  # $ $ $   $  #   
  #  $ $   $ $ ##  
  ##  $  #$ $ $ #  
 ####   ## $ $  #  
 #  #####   $ ###  
 #            #### 
## #$##########  # 
# @              # 
#   #########$#  # 
#####.....    # ###
 #.. #..        $ #
 ##.......#####   #
  #  ..#...#  #####
  ##########       

; 0063_demons_diamonds_15
            ####    
    #########  ##   
    #      ##   #   
######## ..     #   
#       #..## ######
#   $   #..#   $   #
#  $#$  #..#  $#$  #
# $ $ $ #..# $ $ $ #
#  $#$  #..#  $#$  #
#   $   #..#   $   #
###### ##..#       #
   #     ..#########
   # @ ##      #    
   ##  #########    
    ####            

; 0063_demons_diamonds_16
   ####   ####   
 ###@ ## ##  ### 
##  $  ###  $  ##
#  $ $  #  $ $  #
# $ $#$ # $ $#$ #
#  $ $  #  $ $  #
### $  ###  $ ###
 ##   #####   ## 
  ## #  #  # ##  
  #  #     #  #  
  #     #     #  
  # ##  #  ## #  
 ##   #####   ## 
##  .   #   .  ##
#  .#.  #  .#.  #
# . . . # . . . #
## .#.  #  .#. ##
 ## .  ###  . ## 
  ##   # #   ##  
   ##### #####   

; 0063_demons_diamonds_17
   ###########   
  ##  # @ #  ##  
 ## $   #   $ ## 
## $ $  #  $ $ ##
# $ $ $ # $ $ $ #
#  $ $  #  $ $  #
##  $  ###  $  ##
#      # #    ###
# ### ## ## #####
#  ## ## ## #   #
#               #
## ##############
#   ##  #  ##   #
#               #
#  ### ### ###  #
####... # ...####
   #.... ....#   
   ###. # .###   
     #. # .#     
     #######     

; 0063_demons_diamonds_18
   ###########   
  ##  # @ #  ##  
###     #     ###
#   $   #   $   #
#  $ $  #  $ $  #
# $ $ $ # $ $ $ #
## $ $ ### $ $ ##
### $  # #  $ ###
##### ## ## #####
#   # #   # #   #
#       #       #
####### # #######
# #   # # #   # #
#               #
# ### ##### ### #
###... ### ...###
  #....   ....#  
  ###. ### .###  
    #.  #  .#    
    #########    

; 0063_demons_diamonds_19
#####################
#.........#.........#
#......*******......#
#..#..*...#...*..#..#
#..#.*.#######.*.#..#
#..#$$#.......#$$#..#
#...$  ***.***  $...#
#..#$ $# $ $ #$ $#..#
#...$ $ $ @ $ $ $...#
#.##$  $  $  $  $##.#
###  $    $    $  ###
# $$  $  $#$  $  $$ #
# $   $  $ $  $   $ #
# $$$ $$     $$ $$$ #
#   ##$ $$$$$ $##   #
#   $ $  # #  $ $   #
# $$   $ # # $   $$ #
# $  $  $$ $$  $  $ #
# $$$     $     $$$ #
#                   #
#####################

; 0063_demons_diamonds_20
  ####### #######  
###  #  ###  #  ###
#    $   #        #
#  .*@$. . .**$   #
## * * * . *   $ ##
 #$.* $.*. *.* $## 
 # * * $.  .$ $  # 
 # .* $ .  .**$. # 
 #   $   # $   $ # 
 ##  #  ###  #  ## 
  ####### #######  

