; 0291_ay_carumba_1
 ###### 
 #    # 
 #$##.# 
## ##.##
#  @$. #
# $    #
###  ###
  ####  

; 0291_ay_carumba_2
 ####  
 #  ###
 #$   #
 #@$. #
##$#.##
#   .# 
#    # 
###### 

; 0291_ay_carumba_3
 ##### 
 #   # 
##..$# 
#  . # 
# ..$##
##$$$ #
 #@   #
 ######

; 0291_ay_carumba_4
####### 
#  @  ##
#  $*$ #
### .  #
  ##. ##
   #.$ #
   #   #
   #####

; 0291_ay_carumba_5
   #### 
####  # 
#  #$.# 
#   $.# 
#  #$.##
## #   #
 #  @  #
 #######

; 0291_ay_carumba_6
####### 
#     # 
# ##$.# 
# $  .##
####$.@#
   #   #
   ##  #
    ####

; 0291_ay_carumba_7
  ##### 
 ##  .##
 #.$ @ #
##$ $  #
# . ####
# $ #   
# . #   
#####   

; 0291_ay_carumba_8
  #### 
###  ##
# .   #
#.. $ #
# $ ###
### ## 
  #@ # 
  #$ # 
  #  # 
  #### 

; 0291_ay_carumba_9
#########
#   @.. #
# $$$   #
### ### #
  #    .#
  #######

; 0291_ay_carumba_10
#####    
# . ###  
# . $ ###
# @ .   #
## #.#  #
 # $  ###
 ##$$ #  
  #   #  
  #####  

; 0291_ay_carumba_11
  #### 
###. # 
# @ $##
# *** #
##    #
 #    #
 ######

; 0291_ay_carumba_12
 #####  
 #@. #  
##  $###
#  *   #
# * *  #
##   ###
 #####  

; 0291_ay_carumba_13
  #### 
 ##  # 
## $ # 
# .$.##
#  $. #
###@  #
  ##  #
   ####

; 0291_ay_carumba_14
####### 
# .$  ##
#      #
##$ #  #
# $ #  #
#.. ####
## @#   
 ####   

; 0291_ay_carumba_15
 ##### 
## @.# 
#..$## 
# $ ###
##    #
 # $  #
 #  ###
 ####  

; 0291_ay_carumba_16
    ####
  ###. #
###  ..#
#  $  ##
# $  ## 
# $ @#  
#  ###  
####    

