; 0942_the_lost_city_1
##########
###@*  * #
### $ *  #
###  *#  #
### ** # #
## **    #
# * # #  #
# *  .* *#
#    #   #
##########

; 0942_the_lost_city_2
##########
#####   ##
# $   **##
# ** .* ##
#  **   ##
##  @**  #
## *. ** #
##**   $ #
##   #####
##########

; 0942_the_lost_city_3
##########
##  *.  ##
# .* # $##
# . ## * #
# #*     #
# # * *# #
# ** # $*#
#  $    @#
#  #######
##########

; 0942_the_lost_city_4
##########
####     #
#.## @   #
#  ##  $##
#   # $.##
# $  ## ##
##  $##  #
###   . .#
###  #  ##
##########

; 0942_the_lost_city_5
##########
##  .$  ##
## *#** ##
## .$   ##
##  $**.##
# .*  .  #
# $****$ #
#   * * @#
##    * ##
##########

; 0942_the_lost_city_6
##########
#@*  #   #
#$$# $   #
#.* .#$$ #
# *  * * #
#.$#   ###
# * #  ###
# . .  ###
##  #. ###
##########

; 0942_the_lost_city_7
##########
#  #. ####
#..$. .###
#..# $  ##
##  # $  #
##$$ ##  #
##@$ ##  #
###$     #
###   #  #
##########

; 0942_the_lost_city_8
##########
#      * #
# *#$#*$.#
# . * *  #
# $.#  # #
#.$ $.** #
# * . *  #
#* $*$ . #
#@$.   * #
##########

; 0942_the_lost_city_9
##########
# #  .   #
#.#.  .# #
# $.#* $ #
# # #. *.#
# # $*#  #
#  #$ $$$#
# $$  #@ #
# .  . * #
##########

; 0942_the_lost_city_10
##########
#   .. ###
# $$.$$###
#. ###  @#
#. ..#$$ #
## #.$ $##
# .# #   #
# $ $  # #
#. #     #
##########

; 0942_the_lost_city_11
##########
### * .  #
## $ .#$ #
# ...$ **#
#$$# . $.#
#  #*.$#@#
# ## # $$#
#.$ $   .#
#   .   ##
##########

; 0942_the_lost_city_12
##########
###### .##
# $ $ $@##
#. .$*.$##
#. $#...##
#   $ $$##
##$#.... #
# $  $   #
#   ######
##########

; 0942_the_lost_city_13
##########
### .....#
## $..*..#
##  .###.#
#  $### *#
#    $  .#
## $ $ $.#
##$$$$$$$#
##   @   #
##########

; 0942_the_lost_city_14
##########
#  . . . #
#  * * * #
#..$ * * #
#*$*$#$* #
#  * $ * #
#  # * * #
# *$ $.$ #
#.$ .+.$ #
##########

; 0942_the_lost_city_15
##########
#   $ .  #
# .$.* $.#
# $ * *  #
#$.* * * #
# * *$* $#
#. * # * #
# $.*.$.@#
# .  $  ##
##########

; 0942_the_lost_city_16
##########
# .    * #
#* **$.$ #
# *  .#$ #
# .$ $ * #
# *.#. * #
# $ $$* .#
# #.*. $ #
#@$ *  . #
##########

; 0942_the_lost_city_17
##########
#       ##
# * ##*# #
# * $  * #
# $ *. * #
#.$#$ .# #
# *.*..$ #
# * $#*$.#
#@       #
##########

; 0942_the_lost_city_18
##########
#      *.#
# $ # *. #
##* ## $*#
# *   *# #
# $ #. . #
# #  **# #
#@$*#  # #
###      #
##########

; 0942_the_lost_city_19
##########
#. . . ..#
# .* #*$ #
# *#$*.$*#
#  $@$ # #
# ***  # #
#    $ $ #
# #### $ #
#.  $   .#
##########

; 0942_the_lost_city_20
##########
#  #.$.* #
#.  .  * #
#.# $ #$ #
# $ # .*@#
# # $*#*.#
#$$$#..* #
#      $ #
# $ .* ###
##########

; 0942_the_lost_city_21
##########
#  . .. ##
# $ *$ $ #
####   $ #
## $. #  #
#.. ###$ #
#  $  $  #
#$***.**.#
# @ $ .. #
##########

; 0942_the_lost_city_22
##########
#   .$@* #
# #$...* #
# $ $ #*.#
#   ###..#
# $$$ #* #
###   #. #
#   $  $ #
#   $ *..#
##########

; 0942_the_lost_city_23
##########
#  #   ###
#   $.* ##
#  ###.$##
#$     $.#
#..$.* #@#
#$**#$$ $#
#.   ..$ #
# $..$ . #
##########

; 0942_the_lost_city_24
##########
#   #   .#
#$    ..*#
#   ###..#
#*$ $  #.#
#.  # $$.#
# # $  # #
#*$$$#  .#
#@ $ ..$ #
##########

; 0942_the_lost_city_25
##########
### ..   #
###$*..$ #
## @# #$$#
##$$$  *.#
#  $ # $.#
#  # ..  #
#  #  ## #
####. $ .#
##########

; 0942_the_lost_city_26
##########
## ..... #
## ..###$#
## .#    #
##$*$$ # #
#    $  .#
# $# ##$.#
# $ $# $ #
#  @ #   #
##########

