###################
# @               #
##    $           #
############      #
#.                #
###################