######
# . .#
# $$ #
# @  #
######