; 0478_zelja_1_1
     #####               
    ##   #               
   ##  . ##########      
  ##  .  ##      ###     
 ##  .  ## $  $  @ ##    
##  .  ## $  # #  $ ##   
#  .  ## $  ## ##  $ ##  
# .  ## $  ##   ##  $ ## 
### ## $  ##  *  ##  $.##
#     $  ##  * *  ##  $.#
##      ##  * * *  ##...#
 ########  * *.* *  #####
        ##  * * *  ##    
         ##  * *  ##     
          ##  *  ##      
           ##   ##       
            #####        

; 0478_zelja_1_2
       ########           
       #      #           
       # #  # #           
       # #### #           
######## ###  ##          
#....... ###   ##         
####    #### $  ##        
#####  #####  $  ##       
#  @#  # ####  $  ##      
# #$## #    ##  $  ##     
# $  # #     ##  $  ##### 
# # $# ##     ##  $  #####
# #  $  #      ##  $ #...#
# $  $  #       ##  $$...#
# $# # ##        ##   ...#
#  # # #          ########
#      #                  
########                  

; 0478_zelja_1_3
     ###     
    ## ##    
   #######   
  ##     ##  
 ## .@$ . ## 
### #$.$# ###
# # $.*.$ # #
### #$.$# ###
 ## . $ . ## 
  ##     ##  
   #######   
    ## ##    
     ###     

; 0478_zelja_1_4
          ###          
         ##.##         
        ##   ##        
       ##     ##       
      ## . $ . ##      
     ##   $.$@  ##     
    ##   $.$.$   ##    
   ##   $.$.$.$   ##   
  ##   $.$.$.$.$   ##  
 ## . $.$.$.$.$.$ . ## 
##   $.$.$.$.$.$.$   ##
#. .$.$.$.$.$.$.$.$. .#
##   $.$.$.$.$.$.$   ##
 ## . $.$.$.$.$.$ . ## 
  ##   $.$.$.$.$   ##  
   ##   $.$.$.$   ##   
    ##   $.$.$   ##    
     ##   $.$   ##     
      ## . $ . ##      
       ##  .  ##       
        ##   ##        
         ##.##         
          ###          

; 0478_zelja_1_5
    #########    
    #########    
  ### # @ # ###  
  ##    *    ##  
###    * *    ###
##    * $ *    ##
###  * $ $ *  ###
##  * $ $ $ *  ##
#  * $  *  $ *  #
# * $ $*.*$ $ * #
#  * $  *  $ *  #
##  * $ $ $ *  ##
###  * $ $ *  ###
####  * $ *  ####
  #####. .#####  
  ###   .   ###  
  ##.... ....##  
  ###...#...###  
  ####.###.####  
  #############  

; 0478_zelja_1_6
    ########################
   ##        #             #
  ##  $ $ $   $ $ $ $ $ $  #
 ##  $ $ $ $ # $ $ $ $ $ $ #
##  $ $ $   ### $ $ $ $ $  #
#  $ $ $ $ ##.## $ $ $ $ $ #
# $ $ $   ##...## $ $ $ $  #
## $ $ $ ##.**..## $ $ $ $ #
#       # ##..**.## $ $ $  #
#      ### ##.....## $ $ $ #
#  $  ##.## #......## $ $  #
# $  ##...##......*.## $   #
#   ##.**.... ....*..##    #
# $  ##..**....##..*..#    #
#  $  ##......# ##.*.##    #
# $ $  ##.....## ##.##     #
#  $ $   ....*.## ###      #
#   $     ...*..## # $     #
# $  $  #  ...*..##  ##    #
#  $   #   ##.*.##  $##   ##
#    $   $  ##.##  $   $ ## 
# $ $ $ $ $  ### $ $$   ##  
#             #   @    ##   
########################    

; 0478_zelja_1_7
######################
#    .  $.  $.  $    #
#    #.$  .$  .$#    #
#   # $.  $.  $. #   #
#  # $  .$  .$  . #  #
###@$   $.  $.   . ###
#  # $  .$  .$  . #  #
#   # $.  $.  $. #   #
#    #.$  .$  .$#    #
#    .  $.  $.  $    #
######################

; 0478_zelja_1_8
      ###########
      ###########
      ##       ##
      ## ***** ##
######## *   * ##
######## * + * ##
##       *   * ##
## *********** ##
## *     *     ##
## *     * ######
## *  $  * ######
## *     * ##    
## *     * ##    
## ******* ##    
##         ##    
#############    
#############    

; 0478_zelja_1_9
    ######    
   #      #   
   #      #   
 ###......### 
#  .$$$$$$.  #
#  .$    $.  #
#  .$ $ $$.  #
#  .$$@$ $.  #
#  .$    $.  #
#  .$$$$$$.  #
 ###......### 
   #      #   
   #      #   
    ######    

; 0478_zelja_1_10
    ######    
   ########   
   #      #   
 ###......### 
## .$$$$$$. ##
## .$  @ $. ##
## .$ $ $$. ##
## .$$ $ $. ##
## .$    $. ##
## .$$$$$$. ##
 ###......### 
   #      #   
   ########   
    ######    

; 0478_zelja_1_11
  #########  
  #       #  
###.*.*.*.###
# .$ $ $ $. #
# * * *.$ * #
# .$ $ $ $. #
#@* * * * * #
# .$ $ $ $. #
# * * * * * #
# .$ $ $ $. #
###.*.*.*.###
  #       #  
  #########  

; 0478_zelja_1_12
###############    
#             #    
# $ $.*.* $ $ ##   
## $ *.*.$ *.* ##  
 ## $.*.*@*.*.$ ## 
  ## *.*.$.*.* $ ##
   ## $ $ *.* $ $ #
    ##            #
     ##############

; 0478_zelja_1_13
      ###        ###          
     #   #      #   #         
    #  $  #    #  .  #        
   #  $.$  #  #  .$.  #       
  #  $.$.$  ##  .$ $.  #  #   
 #  $.$.$.$    .$   $.  ##.#  
#  $.$.$.$.$  .$     $.  . .# 
# $.$.$.$.$.$.$   $   $.. @ .#
#  $.$.$.$.$  .$     $.  . .# 
 #  $.$.$.$    .$   $.  ##.#  
  #  $.$.$  ##  .$ $.  #  #   
   #  $.$  #  #  .$.  #       
    #  $  #    #  .  #        
     #   #      #   #         
      ###        ###          

; 0478_zelja_1_14
                     ########  
                    #        # 
                    # ******+ #
                    # *     * #
                    # * ### * #
                    # * ### * #
                ##### * ### * #
               #      *     * #
               # ***** ****** #
               # *    *       #
               # * ## * ###### 
            #### * ## * #      
           #     *    * #      
           # **** ***** #      
           # *   *      #      
       ##### * # * #####       
      #      *   * #           
      # ***** **** #           
      # *    *     #           
      # * ## * ####            
 ###### * ## * #               
#       *    * #               
# ****** ***** #               
# *     *      #               
# * ### * #####                
# * ### * #                    
# * ### * #                    
# *     * #                    
# $****** #                    
#         #                    
###########                    

; 0478_zelja_1_15
   #######   
  #   @   #  
  # $ $ $ #  
   # $ $ #   
    # *  #   
   # .$. #   
  # .$.$. #  
 # .$.$.$. # 
# .$.$.$.$. #
#.$.$.$.$.$.#
#  $.$.$.$  #
 #  $.$.$  # 
  #  $.$  #  
   # .$. #   
    #. .#    
     ###     

; 0478_zelja_1_16
           ####   
   ###    ##  ##  
  ##+##  ##    ## 
 ##...#### $ $  ##
##.....   $ $ $  #
#.. . .. $ $ $ $ #
##..... # $ $ $  #
 ##...#### $ $  ##
  ##.######    ## 
  ## ######   ##  
 ## $ ####   ##   
## $ $ ##   ##    
# $ $ $     #     
#  $ $  #####     
##  $  ##         
 ##   ##          
  #####           

; 0478_zelja_1_17
           #####  
   ###    ##   ## 
  ##+##  ##     ##
 ##...####  $ $  #
##.....  # $ $ $ #
#.. . ..  $ $ $  #
##.....  # $ $ $ #
 ##...####  $ $  #
  ##.######  $  ##
  ## ######    ## 
 ## $ ####    ##  
## $ $ ##    ##   
# $ $ $      #    
#  $ $  ######    
##  $  ##         
 ##   ##          
  #####           

; 0478_zelja_1_18
##########     
####   ###     
#   $ $  #     
#@ $   $$#    #
#######  #   ##
  #####$  # # #
 ######    #  #
#######       #
####. .#      #
 ###. ..#  #  #
 #  . .#   #  #
 #    #    #  #
 #   #    ##  #
 #  #    # #  #
 #      #     #
  #   # $     #
   #    #     #
    ###########

