; 0602_lexical_catalysts_1
 ##### ##### ##### ##### ### ####### #### ### 
#@    #     #     #     #   #       #    #   #
# $$..$$$....$.#..$$$#..$.#.$.#.$.$$$$#..$.. #
# $.$.$..$..$.$..$.....$.$..$$..$...$...$.$. #
 #$.$.$$$..$$$$$.$.$$.$$$$$.$.$.$...$..$$$$$# 
# $.$.$.$#.$.$.$.$..$.$.$.$.$.#$$#$.$..$.$.$ #
# $$..$..$.$...$..$$..$...$.$...$.$$$..$...$ #
#        #     #   #  #     #     #    #     #
 ###   ######## ### ## ##### ##### #### ##### 
# $  # $ $ #                                  
# $  #  $  #                                  
# $$ # $$$ #                                  
#    #     #                                  
 #### #####                                   

; 0602_lexical_catalysts_2
 ########## ### ############## 
#          #   #              #
# #***** $ # $ *@***** $$$$*# #
# .*     $ # $ # *         $. #
# #* *** $ # $ * *****# $$$ # #
# .*   * $ # $ # *     $    . #
# #*****  $*$  * ***$* *$$$$# #
# *        #   #            * #
# # # ##### ### ############# #
# #. ... . # . # .....$.....# #
# #.$ $ $. # . * .#$       .# #
# #.#...#.$#$.###.....$#... # #
# #. $ .$. $ . * .#$   .    # #
# #.....  ...  # .....$... .# #
# ############# ######### # # #
# *        #   #            * #
# #*$$$$ * # * * $$$$$ *****# #
# .$     * # * # $         *. #
# #* $$$ * # * * *$$$$# *** # #
# .$   $ * # * # $     *    . #
# #*$$$*  ***  * $$$$$ *****# #
#          #   #              #
 ########## ### ############## 

