; 0973_cjcjc_1
      ##########     
     ##        #     
   ###  ****** ##    
  ##   **    *  ##   
  # $ **  #* **  ##  
 ##  **  # *  **  ## 
##  **  ** **  **  ##
#  **  **   **  **  #
# **  **  *  **  ** #
# *  **  #*#  **  * #
# **  **  *  **  ** #
#  **  **   **  **  #
##  **  ** **  **  ##
 ##  **  * #  *+  ## 
  ##  ** *#  ** * #  
   ##  *    **   ##  
    ## ******  ###   
     #        ##     
     ##########      

; 0973_cjcjc_2
 ############# 
 #           # 
 # **#####** # 
 # *       * # 
## * ***** * # 
#  * #   # .$##
# +* # * # *$ #
## * #   # *  #
 # * *.*.* * ##
 # *  $ $  * # 
 # **#####** # 
 #           # 
 ############# 

; 0973_cjcjc_3
###############################################################
#@                                                            #
# #*#*#*#*#*#*#$#*#$#$#*#.#$#*#.# #*#$#.#*# #.#*#*#$#*#.#*#*# #
# $   * . .   $ . . .   . $     * $ . *   $ $   * $ *   *     #
# #.#*#$#$#*#.#*#$#.#*#*#.#*#*# #$# #*#.#*#*#.# #.#.#*#$#*#*# #
# .   $ .   $ $   . $     *   . . .   $ $   . $ $   . . $ * * #
# #$#*# #*# #.#*# #$#.#*# #.#$#*#.# #*# # # # #*#$# #$# #.# # #
# . $ * *     .   * $ * . $ *     * *   * * *   * * *   *     #
# #*# #*#$#.#*#.#*#.#*# # #$# # #.#$#.#.#*# #*#*#.#*#*# #*#*# #
#   *   $ . $   * .     $ *   * * *   * $   $ * . . .         #
# #.# #*#*#$#$#$# #.#.#$#.#*#.#.# #$# #.#*#$#.#$#$#$#*#$#$#*# #
# $   . * . . . . $ * *   $   * $ $ . * $ *   *   *   * *   * #
# #$#$#$#$#$#*# #$#$#$# #$#*# #*#$#.# # #.#.# # #.# #.#.#*# # #
# * *     $ *   * .   $ . $ . $ . . $ $ * . $ . $   $ .     . #
# #.# #*#$#.#$#*#$#*# #.#.#$#.#$#$#*#*#.#$#*#*#$#*#*# #*#.#*# #
# * $   * * * .   . . . $ $   * .       $ $ .       . $   $   #
# #.#.#$# # #*#.#*# #$#.# #.#$#$#$#.#*#*#.#*#*#*#$# #*#$#.#$# #
# * $ $ * .   $ $     * $ * $ . . . $ $   .     . . *   . $ . #
# #.# #.#.# #$#*#.#*#.#.#$#*#.#$#*#*#.#$#.#$#*#*#*#$#.#$#*#.# #
# * . * $ $ * *   * . * . $ . * $ * $   . * . $ * * . $   . $ #
# #$# #.#*# # #*#$#$#$#$#$#$#$# #.# #*#$#$#$#.# # # #.# #.#*# #
# *   $ . * .   $ . * $   . $ .   $ .     *   . . $ * $ $   * #
# #.#*#$# # #$#*# #$#.#$#.#.#*#.#.#$#*#.# #*#$# #*#*#$#*#*#$# #
# * $ * * $ * * . . * .   * $ * *   .   * *       $     $ . * #
# # # #.#.# #.#$#$# #$#*#$# #.#$#*#$#$#$#.#*#$#*# #$#*#.#.#.# #
# . . $   * $ * $ *   . * $ . * $ . * .     $ .   * * $   *   #
# #$#$#$#.# #.# # #$# #$#.#*# # #$# #*#$#*#.#$#.#.#.# #$#*#.# #
# . * *   $ $ . * * * * $ .   * * * $ . * $   . *   * . $   * #
# #*# #*#.#.#*# #.# #.# #*#$#.# #.#.#$#.#.#*#$# #$# #*#.#$#$# #
# . *   $ . $ *   .     $ * * $ .   *       $ . $ *   $ * . . #
# #$# #*#.#*# #$#*# #*#*# # #.# #$#$#*#*# #$#*#$# #.#$#.#$#*# #
# . $ $ . * * . * $ $ $ * * $ . $ .   *   . $   . $ . . $   . #
# #*# #.#$# # #$#.#.# # # # #*#.# #*# #*#$#.#*#*#.#*#*#.#$#*# #
# * $ $ . $   $ . $ . . * $ $ .     *   . .           $ . . $ #
# #.# #$# #$#.#*# #*# #*#.#.#$#.#*#$#$#*#$#.#.#*#*#*#.#$#$# # #
# . $ * * * .     $ . .     $   $   *     . $ $       *   . * #
# #*#.#.# #*#$#.#.#.#*#.#*#$#*#*#$# #*# #*#$#$#$#*#$#.#$#*# # #
#   $   *   . $ $ $ $   . $ . . * * $ . *   * * * .   . . $ * #
# #$#*#.#*#*# # #*#*#.#*#*#$#$# #.#.#*#$#$#.#.#.#$# #*# #.#.# #
# . * $ . $   * . $ $   $ *   .   * $   . . * $ *   * . $ . * #
# #*#.#$# #*#.#.#$# #*# # #*#.#$#$#.#*#$#*# # # #*#$# # #*# # #
#   $   .   . $ * *   * . $ $ . * .   . *     * *     $ $   * #
# #*#$#$#$#.# #.#.#*#.# #$#.#*# #*#$#*# #*#*#.# #*#.#$#$#$# # #
# $ * . $ * $   *   $ * . $ . . $   * * * $   . $   * . . * . #
# #.#.#*#.#$#*# #*# # # #.#$#$# #$# # # #.#*# #*#.# #$#.#*#$# #
# $       $ * .   . . * $ . .   . * * $ . $     $ $ *   $ .   #
# #*#$#*# # #$#*#$# #*#*# #.#*# # #.#.#.# # #$# #*#*#*# #*#*# #
#   * .   . $   *     $ * $ * . *       * . * *     $   $ * . #
# #$#$#.#$#*#$#.#*#.#*# #$#*#$#$#.#*#.#*#$#*# #*#$#.#*# # #$# #
# . * * $ .   * $ . $ $ *   $     $   . $   .   . $ *   .   . #
# #$# #.#*# #*# #.#*# # #*# #*#*#*#$#*#$# #*#*#*# # #.# #*#.# #
# . * *   $ $ . $ . . * * $ . * $ $ $ * . * . . $ * * * . $ * #
# #$#.#$#.# #$# # #$# # # #*# #.#.#.# #$#*# #$# #.# #$#.# # # #
# . $ . . $ . . *   $ * * . $ . *   * $ $   $ .   . * $ $ * * #
# #*# #.# #.#.#*#*# #*#.#$#.# # # #*# # #*#*#$#.# #.#.#$#*#*# #
#   * * *   $ * . $ . * $   . $     . * .   $   * * *   * *   #
# #*#$#$#*#$#.#$#.#.#$# #$# #*#$#*#.#*#*#*#.#*#*#*# #$# # #*# #
# * $ $ . . $     . $ . * . * * $   * . $ . . * $   $ . $   * #
# #.#.#*#$# #$#*# #*# #*#$#*# # #*# # #$#*#$# # #*# #$#.#.#$# #
#     $ $ * . * . * . . * * $ * * $   $ . $   $ * . * * * . * #
# #*#*#.#.#*#.# #*# #$#$#.#.# #.#.# #*#.#*#*#.#.#$# #.# #$#.# #
#                                                             #
###############################################################

; 0973_cjcjc_4
###############################################################
#@                                                            #
# ##*##*##$##*##*## ##$##*##$##*##*##*##$##*##$##*##$##*##*## #
# #  #  #  #  #  #  #  #  #  #  #  #  #  #  #  #  #  #  #  ## #
# .  *     .  .  $  *     .  $  $  *  .  *  $  .        $  .  #
# ##$ #* #* #  #* #* #* #* #  #. #  #$ #. #  #* #. #$ #. #* # #
# #  #  #  #  #  #  #  #  #  #  #  #  #  #  #  #  #  #  #  ## #
# *  *  $     .  .  .     *  $  *     .  $  .  $  $  *        #
# ##  #. #* #$ #  #$ #$ #. #  #. #  #. #. #* #. #$ #. #$ #$ # #
# #  #  #  #  #  #  #  #  #  #  #  #  #  #  #  #  #  #  #  ## #
#    $  $        $  $     .  *     *  $              *  .  *  #
# ##* #. #$ #* #$ #  #* #. #  #* #* #* #* #. #* #  #$ #* #  # #
# #  #  #  #  #  #  #  #  #  #  #  #  #  #  #  #  #  #  #  ## #
#    .  *  *  .  .  .  .  $  $  .  *  $     *     .  $  .  *  #
# ##* #$ #  #$ #* #$ #$ #  #. #  #$ #  #. #  #* #  #* #$ #. # #
# #  #  #  #  #  #  #  #  #  #  #  #  #  #  #  #  #  #  #  ## #
# .  $     $  .     .     *  .  *  $  .  $  *     .        *  #
# ##* #* #  #. #* #. #  #* #  #. #  #* #* #* #* #* #* #. #* # #
# #  #  #  #  #  #  #  #  #  #  #  #  #  #  #  #  #  #  #  ## #
# *  .  .  *  $     *  *  $  $  $     *  $  *  .              #
# ##  #  #* #* #$ #* #$ #  #$ #  #* #  #. #  #$ #$ #* #. #* # #
# #  #  #  #  #  #  #  #  #  #  #  #  #  #  #  #  #  #  #  ## #
# *  $  $  *  $  $        *  .  .  .  .  $  *  .  $     *  .  #
# ##. #* #  #  #. #* #$ #  #* #$ #$ #* #. #  #$ #. #* #* #$ # #
# #  #  #  #  #  #  #  #  #  #  #  #  #  #  #  #  #  #  #  ## #
# .        *     $  *  .  *  *  *  $  *  $  $     $  .  *  .  #
# ##. #$ #* #. #* #. #$ #. #  #. #  #  #. #  #. #$ #* #  #$ # #
# #  #  #  #  #  #  #  #  #  #  #  #  #  #  #  #  #  #  #  ## #
# *  *  $     .     *     .  $  *  .     *  *        *  $  .  #
# ##$ #. #* #$ #$ #. #. #. #  #. #$ #* #  #  #* #$ #  #  #* # #
# #  #  #  #  #  #  #  #  #  #  #  #  #  #  #  #  #  #  #  ## #
#    .  *  $     $     *  $  *     .     $  .  $  *  $  .  $  #
# ##$ #$ #  #$ #  #$ #* #$ #. #$ #* #$ #. #. #* #  #. #. #. # #
# #  #  #  #  #  #  #  #  #  #  #  #  #  #  #  #  #  #  #  ## #
# *     *  *  .  *  *  .     $  .  .  .     *     *     $  .  #
# ##. #$ #  #* #. #  #$ #$ #  #* #  #* #  #. #* #. #* #* #$ # #
# #  #  #  #  #  #  #  #  #  #  #  #  #  #  #  #  #  #  #  ## #
# .  $  $  *     .  $  $  .  $  .  $  .  $           $  *     #
# ##* #  #. #$ #* #  #. #* #  #* #. #$ #* #* #$ #  #* #. #* # #
# #  #  #  #  #  #  #  #  #  #  #  #  #  #  #  #  #  #  #  ## #
# *     .  $  $     $  *     .  *  $  .     $  *  .  .     $  #
# ##  #$ #* #  #. #. #. #* #  #$ #$ #* #  #  #. #$ #  #. #. # #
# #  #  #  #  #  #  #  #  #  #  #  #  #  #  #  #  #  #  #  ## #
# *  *  *  $  .  $  *     .  .  $  $     *  .        *  *  $  #
# ##. #  #  #* #$ #. #$ #* #* #. #  #. #* #$ #* #* #* #$ #  # #
# #  #  #  #  #  #  #  #  #  #  #  #  #  #  #  #  #  #  #  ## #
#    .  *  .  *  $  *  .     $     $  $  *  *  .  $  .  .  *  #
# ##* #* #. #$ #  #. #$ #. #  #* #. #* #  #. #$ #  #* #$ #  # #
# #  #  #  #  #  #  #  #  #  #  #  #  #  #  #  #  #  #  #  ## #
# $  $        $     .  .  $     .  $  .  *        .     *  .  #
# ##. #* #* #. #$ #* #$ #* #* #  #* #  #* #* #$ #* #. #$ #* # #
# #  #  #  #  #  #  #  #  #  #  #  #  #  #  #  #  #  #  #  ## #
# $     .     .  *     $  .  .  *     .  *     $  *  $  $  .  #
# ##. #* #$ #$ #$ #* #  #* #$ #  #$ #$ #  #$ #. #. #. #. #$ # #
# #  #  #  #  #  #  #  #  #  #  #  #  #  #  #  #  #  #  #  ## #
# $     $  .  .  $  .  .  $  $  *  *     *  *  *        $  *  #
# ##* #. #* #. #* #* #$ #  #. #. #  #$ #. #  #  #. #* #* #  # #
# #  #  #  #  #  #  #  #  #  #  #  #  #  #  #  #  #  #  #  ## #
# *     $  .  .  $     .  .  $  *  *     .  *  .     *  $  *  #
# ##* #  #. #$ #* #$ #* #$ #  #. #  #* #* #  #$ #* #  #. #  # #
# ## ## ## ## ## ## ## ## ## ## ## ## ## ## ## ## ## ## ## ## #
#                                                             #
###############################################################

; 0973_cjcjc_5
###############################################################
#@                                                            #
# ##$##*##$##$##*##*##*##$##.## ##*## ##.##.##*##.##.##.##.## #
# ## ## ## ## ## ##  # ##  # ## ## #  ##  * ##  # ## #  ## ## #
# .  *     *  .     .  $     *  $  .  $  $  $     *  $  $  *  #
# ##* #$##. #. #$ #*#  ##$# $# .##$ #$##*##$# $##$##$ #. #$ # #
# ## *# ## ** ## ##  # ## ** ##  # *# ## ## ** ## ## *# ## ## #
# *  *  .  *  $        *  .  *  *  *  *  *  .  .        .  *  #
# #  # *## ##* #. #.##* # ##### ##.##  #  #*##  #.##*##* *$## #
# ## ## #  ## ## ## ## *#  # ## #  ## ## ** #  #  #  ## ## ## #
# $  .     .  *  *     .     $  *     .        *  $        .  #
# ##. #$ #$##$# $## # *##$##  * ##.##.## ##*## ##.##*##*##*## #
# ## ## ## ## ** ## ## #  ## #* ## ##  # ## ## #  ##  * #  ## #
# $  .  .  $  $     *  *  .  .  *  $  $  #     #  *  .        #
# # *##$ #.## ##*# $##  #.##.##  #. # # *##.# $## #  ##. #  # #
# ##  * ## #  ## #* #  ##  # ## *# ## #* ## #* #  #* ## ## ## #
# *  *     .     #  *     $  *  *  $  $     .  $  #  $  *  *  #
# ## ##  #*##$ **##.##.##*## ##*# *#  ##*##$##  #$## ##  #*## #
# ##  # *# ## ## ##  # #  ## ## ## ##  # #  ## ## ## #  ## ## #
# *  .  *  .  $      # $  .  $  *  .  $  .  .  *     *  *  .  #
# #  #  ##  #.##*## ##$ #$##$#  #  # *#  ##  *.##$##  #*##  # #
# ## ## ## ## ##  #  # ## #  #* ## ## #* #  #* ##  ###  ## ## #
#    *  .  $  $     *  #     .     *  .  *  *     $     .  $  #
# ##$##*##$ #  #$##.##.##$##* ### .##  #* #.##*##*##$##* #*## #
# ##  * ## #####  #  #  * #  ## ## #  ## ##  # ## #  ## ** ## #
# *     $  *  *        *  *        $  $     $     .     .  .  #
# ##.##*#  ##  * # *# *##  #* *$# *##* #$#  ##*#####.## ## ## #
# ## #  #* ## ## ## ##  * ## ## ** #  ## ** ## #  ## ## ## ## #
#    $  .  .  *     .  .  $   #       *  .  $     #  $  *  $  #
# # *##.##* #$##* #$# $##. #  #$##  #$ **## ##  #.##  #*# *## #
# ##  * #  #  #  #  ## ## #  ## ## *# ## #  ##### ## ## ## ## #
# $           $  #  $  $     $  *  *  $  .     *  .  $  .  *  #
# #  ##*##$##$##.##  #. #.##$##.#  ##.# *##*##*##$ #*##*##  # #
# ## ## #  ##  * #  ## ## ## ## ## ## ##  #  # ## ## ## #  ## #
# .  .  $  *  *  $  *  .  *     .  .  *  $  $  $        $  .  #
# # *## ##.##.##  #.## ##$ #.##$##$ #$# .##.##.#  ## ##$ #* # #
# ##  #  * ##  # ## ## #  ## ## ## ## ## ## ## #* ##  # *# ## #
# .  $     #     $  $  $  *     *     $  *        *  .  *     #
# ##$##$##*##*##. #  *.##.##. *$# *##.##.# *# $##$##$## ##$## #
# ## ##  # ## ## ## *# ## ## ## ## ## ## ## #* #  #  ## ##  # #
# *  *  $  $  .     *     *  $  *        *     *  .  .  .  *  #
# ##.##.## ##*##.# $##$ *.## ##. #.##$# $##$ #.#####  **##*## #
# ## ##  #  # #  ##  # #* ##  # ## #  ## ## *# ##  # *#  #  # #
#    *   # .        $     .        $  *  $  *  $  $  .  $  *  #
# ##$#  #####.##* ####*##*##$##. #*## ##. #.# .##.# $##.#  ## #
# ## ##  # #  ## ## ##  * ## ## *# ##  # ## ## ## ## ## #* ## #
# *        $  .  #     $  .  $  .  $  .  #     #     $  .  *  #
# ##* #.##$ #*## # $# .##* #. #*## # .# $## # *##.##* #$## ## #
# ## ## ## ** ##  # ##  * ## ## #  ## ##  * ## ##  # #  ##  # #
# $     .     *     $  *  $  .  $  $  $  $  *  *     $     .  #
# ##.##$#####. *.##$ *.##. #$##  #.##. # ##.#  ##.##$ #* #*## #
# ## ## ## ## *# #  #* #  ## ## ## ## *#  # #* ## ## *# *#  # #
# .  $  $  .  $  .     $        $  .  $  .  $     .  $  .  $  #
# ##*##.##*# *##$ #.##*##$##*## # *# .##.##$## ##*##$# *# .## #
# ## #  ## ## ## *# ## ##  # ## ** ##  # #  #  #  #  #* #* ## #
#    $  .     *        *     .  *        .  .     *     $  .  #
# # *##.##*# $## ##*##$##*##. #*##* #*##  #  #* #$##*##.## ## #
# #* #  ## ## #  #  ## ## ## ## ## *# ## ## ## *#  #  # ## ## #
#    *     $  $  $  *  *     $  *  $  $  *     .  .  $  $  *  #
# ##*##.##*## ##.##. #.##* #  #.# .##.# $##*#  ##*##*##. **## #
# ## ## ## ## ## ## ## ## ## ## ## ## ## ## ## ## ## ## ## ## #
#                                                             #
###############################################################

; 0973_cjcjc_6
############################
# . * * * * * * * * $ ######
# # # # # # # # # # #.######
# $ $   . . . $       * ####
#$# # # #$#$#$# #.#*#*# ####
# . . * $ $   * *       ####
#*#$#.#*#.#.#$#*# #$#*######
#   $ * $ * . $ . .   # . ##
#*#.# # # # #$#.# #$#*# *$##
#   . $ . . $   $ *   # . ##
#*#$#.#*#.#*#*#$# #.#*# *$##
#       .   $   . $   # . ##
#*# #$# #$#$#*#*# #.#*# *$##
#   . *   * *     $   # . ##
#*#.#$#*#.# #.# #*# #*# *$##
#     . * . $ * $ *   # . ##
#*# #*#$#$#.#.#*# # #*# *$##
#     * $ . * $   .   # . ##
#*# # #.# # #.#*#$# #*# *$##
#   * $ . $       * . # . ##
#.# # # # # # # # # #$  *$##
# $ * * * * * * * .   #** @#
################## ###     #
##################     #  ##
############################

