; 0479_zelja_1
##############
##          ##
# # $    $ $ #
#  # $ $ ##..#
# $ # $ #  ..#
#    #@##  ..#
#     # ###..#
##        #  #
# #          #
#  # $ #     #
#   #   #    #
##   #   #  ##
##############

; 0479_zelja_2
##############
###          #
##          ##
#   ##   ##  #
#   # # #  ..#
#  #   # # ..#
#  $  # ## *.#
#    # @ ##..#
#   #  $$ #  #
#  # $$  $ ###
#      #   $ #
#    ####    #
##############

