; 0472_grigr_challenge_remodeled_1
          #################         
         ##               ##        
        ##  * * * * * * *  ##       
       ##  * * * *** * * *  ##      
      ##  * * * * * * * * *  ##     
     ##  * * * * * * * * * *  ##    
    ##  * * * * * * * * * * *  ##   
   ##  * *** * * * * * * *** *  ##  
  ##  * * * * * * * * * * * * *  ## 
 ##  * * * * * * *** * * * * * *  ##
##  * * * * * * * * * * * * * * *  #
#.   * *** *** * *$* * *** *** *  @#
##  * * * * * * * * * * * * * * *  #
 ##  * * * * * * *** * * * * * *  ##
  ##  * * * * * * * * * * * * *  ## 
   ##  * *** * * * * * * *** *  ##  
    ##  * * * * * * * * * * *  ##   
     ##  * * * * * * * * * *  ##    
      ##  * * * * * * * * *  ##     
       ##  * * * *** * * *  ##      
        ##  * * * * * * *  ##       
         ##               ##        
          #################         

; 0472_grigr_challenge_remodeled_2
       #################        
      ##               ##       
     ##  * * * * * * *  ##      
    ##  * * * * * * * *  ##     
   ##  * * * * * * * * *  ##    
  ##  * * * * * * * * * *  ##   
 ##  * * * * * * * * * * *  ##  
##  * * * * * * * * * * * *  ## 
#  * * * * * * * * * * * * *  ##
# *************$************ @.#
#  * * * * * * * * * * * * *  ##
##  * * * * * * * * * * * *  ## 
 ##  * * * * * * * * * * *  ##  
  ##  * * * * * * * * * *  ##   
   ##  * * * * * * * * *  ##    
    ##  * * * * * * * *  ##     
     ##  * * * * * * *  ##      
      ##               ##       
       #################        

; 0472_grigr_challenge_remodeled_3
       #################        
      ##               ##       
     ##  * * *   * * *  ##      
    ##  * * * *** * * *  ##     
   ##  * * * * * * * * *  ##    
  ##  * * * * * * * * * *  ##   
 ##  * *** * * * * * *** *  ##  
##  * * * * * *** * * * * *  ## 
#  * * * * * * * * * * * * *  ##
# *** * * * * *$* * * * * ***@.#
#  * * * * * * * * * * * * *  ##
##  * * * * * *** * * * * *  ## 
 ##  * *** * * * * * *** *  ##  
  ##  * * * * * * * * * *  ##   
   ##  * * * * * * * * *  ##    
    ##  * * * *** * * *  ##     
     ##  * * *   * * *  ##      
      ##               ##       
       #################        

; 0472_grigr_challenge_remodeled_4
       #################        
      ##               ##       
     ##  * * * * * * *  ##      
    ##  * * * *** * * *  ##     
   ##  * * *** * *** * *  ##    
  ##  * * * * *** * * * *  ##   
 ##  * * * * * * * * * * *  ##  
##  * * * * * * * * * * * *  ## 
#  *** * * * * * * * * * ***  ##
# *   * * * * *$* * * * *   *@.#
#  *** * * * * * * * * * ***  ##
##  * * * * * * * * * * * *  ## 
 ##  * * * * * * * * * * *  ##  
  ##  * * * * *** * * * *  ##   
   ##  * * *** * *** * *  ##    
    ##  * * * *** * * *  ##     
     ##  * * *   * * *  ##      
      ##               ##       
       #################        

; 0472_grigr_challenge_remodeled_5
       #################        
      ##               ##       
     ##  * * * * * * *  ##      
    ##  * * * *** * * *  ##     
   ##  * * *** * *** * *  ##    
  ##  * * * * * * * * * *  ##   
 ##  * *** * * * * * *** *  ##  
##  * * * * * * * * * * * *  ## 
#  * * * * * * * * * * * * *  ##
#   * * * * * *$* * * * * *  @.#
#  * * * * * * * * * * * * *  ##
##  * * * * * * * * * * * *  ## 
 ##  * *** * * * * * *** *  ##  
  ##  * * * * * * * * * *  ##   
   ##  * * *** * *** * *  ##    
    ##  * * * *** * * *  ##     
     ##  * * * * * * *  ##      
      ##               ##       
       #################        

; 0472_grigr_challenge_remodeled_6
       #################       
      ##               ##      
     ##  * * * * * * *  ##     
    ##  * * * * * * * *  ##    
   ##  * * * * * * * * *  ##   
  ##  * * * * *** * * * *  ##  
 ##  * * * * * * * * * * *  ## 
##  * * * *** * * *** * * *  ##
#  *** * * * * * * * * * * *  #
#.*.  * * * * *$* * * *** * $@#
#  *** * * * * * * * * * * *  #
##  * * * *** * * *** * * *  ##
 ##  * * * * * * * * * * *  ## 
  ##  * * * * *** * * * *  ##  
   ##  * * * * * * * * *  ##   
    ##  * * * * * * * *  ##    
     ##  * * * * * * *  ##     
      ##               ##      
       #################       

