; 0680_ac_passing_1
  ###  
  #.#  
  #$###
###   #
#  *  #
# * * #
#* * *#
# * * #
#  *  #
#@    #
#######

; 0680_ac_passing_2
#######  
#   #.#  
# $.#$###
### #   #
  #  *  #
  # * * #
  #* * *#
  # * * #
  #  *  #
  #@    #
  #######

; 0680_ac_passing_3
 ############
 # * *   #  #
 #* * *  #$ #
 # * *   #  #
##* * *   .##
#@ * *   ### 
##* * *  #   
 # * *   #   
 #########   

; 0680_ac_passing_4
 ############
 # * *   #  #
 #* * *  #$ #
 # * *   #  #
##* * *   .##
#@ * *  #### 
##* * *  #   
 # * *   #   
 #########   

; 0680_ac_passing_5
 ############
 # * *   #  #
 #* * *  #$ #
 # * *  ##  #
##* * *   .##
#@ * *   ### 
##* * *  #   
 # * *   #   
 #########   

; 0680_ac_passing_6
   ###########  
   #   * *   #  
   #  * * *  #  
####   * *   ###
#    @* * *  $.#
#.##   * *   ###
#  #  * * *  #  
#$ #   * *   #  
#  ###########  
####            

; 0680_ac_passing_7
         #####  
        ##   #  
   ###### *  #  
####   # *   ###
#    @* * *  $.#
#.##   * *  ####
#  #  * * * #   
#$ #   * *  #   
#  ##########   
####            

; 0680_ac_passing_8
   ###     
####.#     
#    #     
# ##$##### 
# #   ## ##
# #       #
# # * * * #
# #* * * *#
# # * * * #
# #* * * *#
# # * * * #
# #####@###
#       #  
#########  

; 0680_ac_passing_9
######     
#    #     
# ## ##### 
# #   ## ##
# #       #
# # * * * #
# #* * $ *#
# # * * * #
# #* * $ *#
# # * * * #
# #####@###
#       #  
#######.#  
      # #  
      #.#  
      ###  

; 0680_ac_passing_10
######     
#    #     
# ## ##### 
# #   ## ##
# # .     #
# # * * * #
# #* * $ *#
# # * * * #
# #* * $ *#
# # * * * #
# #####@###
#       #  
#######.#  
      ###  

; 0680_ac_passing_11
   ###########  
####   * *   ###
#    @* * *  $.#
#.##   * *   ###
#  #  * * *  #  
#$ #   * *  ##  
#  ###########  
####            

; 0680_ac_passing_12
 #####   
 #   #   
 # $.### 
####   ##
#   *   #
#  * *  #
# * * * #
#* * * *#
# * * * #
#  * *  #
#@  *   #
#########

; 0680_ac_passing_13
      ###   
      #.#   
      #$### 
   ####   ##
####   *   #
#  #  * *  #
#$ # * * * #
#  #* * * *#
# #  * * * #
# #   * *  #
#.  @  *   #
############

; 0680_ac_passing_14
      ###   
      #.#   
      #$### 
   ####   ##
   #   *   #
####  * *  #
#  # * * * #
#$ #* * * *#
#  # * * * #
# #   * *  #
#.  @  *   #
############

; 0680_ac_passing_15
     #####     
    #     #    
   # $$$$  #   
  # .. *..$ #  
 # $* .#.  $ # 
# .$  ###  $. #
# *  #   # $* #
# . #     # . #
#$########### #
#      @      #
#.#############
###            

