; 0293_challenge_1
####  
#  ###
#    #
# $. #
## * #
 #$. #
 # @##
 #### 

; 0293_challenge_2
   ####
####  #
#  .$ #
#  .$@#
###.$##
  #  # 
  #  # 
  #### 

; 0293_challenge_3
  ##### 
  # + # 
### * ##
#  $*  #
#      #
########

; 0293_challenge_4
 ###### 
##    # 
#  ## ##
# $.$. #
## #   #
 # @ ###
 #####  

; 0293_challenge_5
  #####
 ##   #
 #  # #
##+$**#
#   # #
#     #
#######

