; 0923_qualevels_1
   ######
   #    #
####  $ #
#  # $$ #
#   ..$ #
# .## $@#
##.### ##
# .    # 
#    ### 
#   ##   
#####    

; 0923_qualevels_2
#############
# @##########
# $ $ $   $ #
#       #   #
### . . .#$##
##   . .   ##
##$ . # . $##
##   . .   ##
##$#. . .# ##
#   #   #  ##
# $   $ $ $##
#########  ##
#############

; 0923_qualevels_3
 ##### 
##@. # 
# $.$##
#. *  #
# $   #
###  ##
  #### 

