; 0967_jupe_collection_02_1
       ###  
      ##.#  
     ##  ## 
     #+.  # 
     ##*$ # 
      # $ # 
#######.####
#    #  *  #
# #. $$..$ #
# $ $# #   #
# $# #   ###
#    .####  
#######     

; 0967_jupe_collection_02_2
 #####  #####
##   ####   #
#   $       #
#   #.##$####
##$$$.   #   
 #@ #.*.$#   
 ######*.### 
      # .  # 
      #    # 
      ###### 

; 0967_jupe_collection_02_3
  #########
### @     #
#   #####$#
# $ #.....#
##$$$*.# .#
#   #   # #
# ###$    #
#     # #$#
# ##      #
###########

; 0967_jupe_collection_02_4
#########  
#       ###
# $# ## $ #
#    .*...#
##$ $ #.$*#
#  $###*#+#
#       $.#
###########

; 0967_jupe_collection_02_5
        ####
        #@ #
    ###### #
#####    # #
#   $ $  # #
# * #$ $ # #
##.##   ## #
# * *  ### #
#.....$    #
##.##$$ ####
 ####   #   
    #####   

; 0967_jupe_collection_02_6
#####     
#   #     
#   ######
## ##    #
#  .$$$  #
# ..#  $ #
##*##   ##
# * .$ ## 
# .*.*$ # 
###.#@$ # 
  ###   # 
    ##### 

; 0967_jupe_collection_02_7
  ########
  #   #  #
 ##  **  #
 #@$..#  #
 #$#.*#$##
## ...  # 
# $# *#$##
#  $     #
#  ###   #
#### #####

; 0967_jupe_collection_02_8
  ##### 
###.. ##
#   ...#
# $#*$ #
# $ *. #
# $ #.##
###  *.#
#  $$$$#
#   @  #
########

; 0967_jupe_collection_02_9
    #### 
#####  # 
# $   $##
#   $ $ #
##$# ## #
# ....*@#
#   . ###
#######  

; 0967_jupe_collection_02_10
       #####
########   #
#          #
#  $##$# ###
#  .*..# $ #
### #.##.  #
 #  #.##$$##
 #      $@# 
 ###  ##### 
   ####     

; 0967_jupe_collection_02_11
####### 
#. $ .##
## # $@#
# $. * #
#.$ $$##
# #$#  #
#..  . #
########

; 0967_jupe_collection_02_12
#####    
#.  #####
#$# $   #
# .$@$  #
#. #$#$##
#. .*  # 
#. $  .# 
######## 

; 0967_jupe_collection_02_13
######   
#.$ .####
# # $   #
#   $   #
#.$#$#$##
#$.  *.@#
#..   ###
#######  

; 0967_jupe_collection_02_14
###################
#                 #
#  #############  #
# $#  #  #@ #  #  #
#  #   $ #..$  #  #
# $#$ #  #*.#  #  #
#  #  #$ #..#  #  #
# $#$ #  #*.#  #  #
#  #  #$ #..#  #  #
# $ $ #   *.#     #
#  #  #  #..#  #  #
###################

; 0967_jupe_collection_02_15
   #####   
   #   #   
####$ $####
#  $...$  #
#   .*.   #
#  $...$  #
####$ $####
   # @ #   
   #####   

; 0967_jupe_collection_02_16
  #######
  #  .  #
  #$#.$ #
  # #.# #
### #.# #
# @ #.$ #
#   $.$ #
## ## ###
 #  $  # 
 ###   # 
   ##### 

; 0967_jupe_collection_02_17
  #########
###  #    #
#@$ ... # #
# *$*$* # #
# # ... # #
#  $ $ $  #
##  #######
 ####      

; 0967_jupe_collection_02_18
    ####   
   ##  #   
   #@$ ##  
  ##$*  ## 
  #  ..* ##
###$$#.*  #
# $ *..#  #
# $ # .#  #
#      ####
########   

; 0967_jupe_collection_02_19
  #######
### $ . #
# $.#   #
#.    .*#
###  *  #
  ##$$###
   #  @# 
   ##### 

; 0967_jupe_collection_02_20
  #######
  #.  . #
### #   #
# *$$..*#
#       #
####$$###
   # @#  
   ####  

; 0967_jupe_collection_02_21
      ####
      #. #
      #  #
#######$.#
# $ $    #
#.$. *  $#
#+#  #   #
##########

; 0967_jupe_collection_02_22
########  
#  #   ###
#@$ *..  #
# $$ .   #
#  #$* ###
#### . #  
   #####  

; 0967_jupe_collection_02_23
        ####
 ########  #
 # *.$     #
 # ...###$ #
### .#     #
#  .*   $  #
# $*#$#$$ ##
###+     ## 
  ########  

; 0967_jupe_collection_02_24
    ######
 ####@   #
## $ $ $ #
#   # # ##
# .*..$ # 
##$#..# # 
# ...$# ##
# $   $  #
######   #
     #####

; 0967_jupe_collection_02_25
  #######
###     #
#   $$  #
#  $  $ #
##$### ##
#@ *.$  #
## ..*. #
 ##.. ###
  #####  

; 0967_jupe_collection_02_26
  #####  
###   ###
#@$ $   #
# $$    #
##.### ##
# ..*.*.#
#  $ *  #
# $  .###
#######  

; 0967_jupe_collection_02_27
########
#  #   #
#@$$   #
#  *$$##
# #... #
# *..# #
###$.* #
 #   $##
 #    # 
 ###### 

; 0967_jupe_collection_02_28
  ####  
  #  #  
###. ###
# $ $@ #
# .*$..#
# *  $ #
##   ###
 #####  

; 0967_jupe_collection_02_29
######  
#..$ #  
#.#. ###
# $ $ @#
#$.*$*.#
# *  $ #
#. $ ###
######  

; 0967_jupe_collection_02_30
#####    
#.  #    
# # #### 
#      # 
#.#$#$$# 
# #.#  # 
# # .$.# 
# #* $.# 
# # ## ##
#$  @   #
#   #   #
#########

; 0967_jupe_collection_02_31
 ########
##      #
# * *** #
# * $ . #
# ..*$* #
# * $ ..#
# ** ..$#
#  $$$* #
####  @##
   ##### 

