; 0520_brainsport_1
 #########
 #@####  #
 #$#     #
 # #  ## #
 # ## ## #
## ## ## #
#  ## ## #
#     ## #
####  ##.#
   #######

