; 0902_standard_1
 #####
##   #
# @  #
# * ##
# *$# 
# . # 
##### 

; 0902_standard_2
 #####
##   #
#    #
# ** #
##$.@#
# ** #
#    #
######

; 0902_standard_3
######
# ...#
# $# #
# $@ #
# $#$#
#   .#
######

; 0902_standard_4
#######
#.   .#
#  $# #
# $@$ #
# #$# #
#.   .#
#######

; 0902_standard_5
#####    
#.* #####
#.$ .$  #
#  @#   #
##$######
 #  .$  #
 #  #   #
 #  #####
 ####    

; 0902_standard_6
    #####
##### . #
#   $ * #
#   #  .#
#####$# #
    # @ #
    #####

; 0902_standard_7
######  
#    #  
# #.$#  
# $. ###
##  .$ #
 ##$.# #
  #   @#
  ######

; 0902_standard_8
#######
#  #  #
#$ $ $#
#.....#
# $ $ #
#  @ ##
###### 

; 0902_standard_9
    ####
    #  #
  ### $#
  # $ .#
 ## ##@#
 #  # .#
## $#$ #
#.    .#
########

; 0902_standard_10
###### 
#  . ##
# $#$ #
#. @ .#
# $#$ #
## .  #
 ######

