; 0278_the_bagatelle_collection_2_1
####   ####
#  #####  #
#    $  $ #
# ..$# .. #
## . #$.$##
 # .$# . # 
 ##  #$$## 
  #  # @#  
  #######  

; 0278_the_bagatelle_collection_2_2
   ####           
   #  #######     
   #$       #     
  ##..#### $##    
  # *.#  # $ #### 
  # .. $ #   $  # 
  # .* # ##  # $# 
  # ####..## #@ # 
  # #  .*.# $$ $# 
 ## #  #..   #  # 
 #.*.# ### #### ##
##.*.$ #   # $ $ #
#.*..    $ #  $  #
#...## #####$$ $ #
##### $ $ $ $ $  #
    #            #
    ##############

; 0278_the_bagatelle_collection_2_3
#####   #### 
#   #####  # 
# # #.$    ##
#   * $ #   #
### #.### # #
##  # $.* # #
#      .#.# #
# $####$$.* #
#   ## $ .###
### @  ####  
  ######     

; 0278_the_bagatelle_collection_2_4
   ######    
 ###    #### 
 #     *#  # 
 #$$ $ $ $ # 
## #*#*# # ##
# @*.. ...  #
#   #####   #
#####   #####

; 0278_the_bagatelle_collection_2_5
#####     
#   ######
#      $ #
## # #   #
#  *  ####
#.$*$.#   
#. . .#   
# .#$ #   
# .*. #   
#$#$#$#   
#  $  #   
## @ ##   
 #####    

; 0278_the_bagatelle_collection_2_6
#####   #####
#   ## ##   #
# $  ### $  #
## #  # @# ##
 # ##.*.## ##
## # .*..#  #
#    .***$$ #
# $$ ....#  #
###  $#  ####
##  $ ## $ # 
#  $ ###   # 
#   ## ##### 
#####        

; 0278_the_bagatelle_collection_2_7
   ######      
   #    ##     
  ##$##  ####  
  #  .#  #  ###
  #   #  $ $  #
  ### ## #. # #
####. .*.## # #
#    #*#*#  # #
# #$##.*.     #
# #  #.##$#####
# $  $      #  
###  #$ #@  #  
  ####  ## ##  
     ##    #   
      ######   

; 0278_the_bagatelle_collection_2_8
              #######  
#####     #####     #  
#   #######  # .### ###
# $   @      # ..$    #
##### ##$### #$.$ #$# #
# $ $  # .## # . #  # #
#      #$.#  #$* #    #
## #####  #    .#   ###
 # #   .#.# ##$*### #  
 # #.$.   #*## .$ # #  
## ##$#.  .  #$.. # #  
#  ..*.##$## # .### #  
# $.*   $     #     #  
#####  $  # $ #######  
    ##### # $ #        
        # $ # #        
        ###   #        
          #####        

; 0278_the_bagatelle_collection_2_9
            #####    
  #######   #   #    
  #     ##### # #    
  #      #  #   #    
  ##.##  #    $####  
 ##...#  #$###  $ ###
 #  #.*.##  ##$   $ #
 #$##.*.    #   $ $ #
 #  #... ####$  #$  #
 #$ #####.    $# $  #
 #  ## $ .$ # $    ##
 #$....#@ #.###   ## 
 #  #..##*$   #####  
 # #..*.   #  #      
 # #  .*  ## ##      
 #  ##.###   #       
##$$# .# $$  #       
# $  $ $ $  ##       
#     #     #        
#############        

; 0278_the_bagatelle_collection_2_10
 ############### 
 #             # 
 #.## #### ###.# 
 #   * $ $ *   # 
 # $#   $  #$$ # 
##   ##.#.# $  ##
# $$ #..*.. #$  #
#    #.*.*.#    #
####*$*#.#*$*####
#    # *...#    #
# $$ #@.*..# $$ #
##   ##.#.##   ##
 # $$#  $  #$$ # 
 #   * $ $ *   # 
 #.#####.#####.# 
 #             # 
 ############### 

; 0278_the_bagatelle_collection_2_11
        ####  
   ######  ## 
   #@ $     # 
#### $### # ##
#   $ ## .#  #
#  #    ** # #
## ####... # #
 #. ### # #  #
 #$  $  $   ##
 #. ####   ## 
 ####  #####  

; 0278_the_bagatelle_collection_2_12
######### 
#   #   ##
#     $$ #
##.#*.#. #
 #$.  . ##
## .  *$##
#  ##*#  #
# $@$    #
#######  #
      ####

