; 0477_zika_1
#########################                    
#                       #                    
#                       #                    
#  $#$ $ $ $ $ $ $ $ $$ #####################
#   $ $ $ $ $ $ $ $ $   #                   #
#  $ $ $ $ $ $ $ $ $ $  # # # # # # # # # ###
#   $ $ $ $ $ $ $ $ $                      ##
#  $ $ $ $ $ $ $ $ $ $  #. . . . . . . . ...#
#   $ $ $ $ $ $ $ $ $  ##...................#
#  $ $ $ $ $ $ $ $ $ $###...................#
#   $ $ $ $ $ $ $ $ $   #...................#
#  $ $ $ $ $ $ $ $ $ $# #...................#
#   $ $ $ $ @ $ $ $ $   #...................#
#  $ $ $ $ $ $ $ $ $ $  #...................#
#   $ $ $ $ $ $ $ $ $ # #...................#
#  $ $ $ $ $ $ $ $ $ $  #...................#
#   $ $ $ $ $ $ $ $ $   #...................#
#  $ $ $ $ $ $ $ $ $ $# #####################
#   $ $ $ $ $ $ $ $ $  ##                    
#  $ $ $ $ $ $ $ $ $ $###                    
#  #$ $ $ $ $ $ $ $ $   #                    
#  $ $ $ $ $ $ $ $ $ $$ #                    
#                       #                    
#                       #                    
#########################                    

; 0477_zika_2
#########
#. . .  #
#.$.  $ #
## ###@ #
 #  $  ##
 # $$ ## 
 # .$ #  
 #  ###  
 ####    

; 0477_zika_3
    ######    
    #    #    
    #    #    
    #$$ $#    
#####    #####
#   $ *..    #
# $$ ..$. $  #
# @  .*.. $  #
#  $ .... $  #
##### ..$#####
    #$$. #    
    # $  #    
    #    #    
    ######    

; 0477_zika_4
       # #      
#    #######   #
################
 #            # 
 #  $$$ $$$$$ # 
 #..# $    #..# 
 #..#  $ $ #..# 
 #..#    $##..# 
 #..# $$   #..# 
 #.+#     $#..# 
 # $  $ $   # # 
 # #  ####$$# # 
 # # $#.*.  $ # 
 #            # 
 ############## 
##   #####    ##

; 0477_zika_5
    #####    
    #   #    
    ##* #    
##### . #####
##   $* #   #
## $  . ##$@#
## #*.*...  #
##  $ . #$###
## # #*    ##
#####  $#####
    # $ #    
    #   #    
    #####    

; 0477_zika_6
###################################
#..... $ $ $ $ $   $ $ $ $ $ .....#
#.....  $ $ $ $ $ $ $ $ $ $  .....#
#..... $ $ $ $ $   $ $ $ $ $ .....#
#.....  $ $ $ $ $ $ $ $ $ $  .....#
#..... $ $ $ $ $   $ $ $ $ $ .....#
#.....  $ $ $ $ $ $ $ $ $ $  .....#
#..... $ $ $ $ $   $ $ $ $ $ .....#
#.....  $ $ $ $ $ $ $ $ $ $  .....#
#..... $ $ $ $ $   $ $ $ $ $ .....#
#.....  $ $ $ $ $@$ $ $ $ $  .....#
#..... $ $ $ $ $   $ $ $ $ $ .....#
#.....  $ $ $ $ $ $ $ $ $ $  .....#
#..... $ $ $ $ $   $ $ $ $ $ .....#
#.....  $ $ $ $ $ $ $ $ $ $  .....#
#..... $ $ $ $ $   $ $ $ $ $ .....#
#.....  $ $ $ $ $ $ $ $ $ $  .....#
#..... $ $ $ $ $   $ $ $ $ $ .....#
#.....  $ $ $ $ $ $ $ $ $ $  .....#
#..... $ $ $ $ $   $ $ $ $ $ .....#
#.....  $ $ $ $ $ $ $ $ $ $  .....#
###################################

; 0477_zika_7
                    ######  
######   #####      #    #  
#    #   #   ##     #    #  
# **.#   # $  #  #  # $**#  
# ...#   #$$.*##### # ...## 
# ***#   # .. #   ###$*.. # 
# ...##### ** #  $$   ...## 
# *.. $ $   # # $ $$$ #$##  
# ..* # #     # $       ####
# *..    ##$         $ $$  #
#  # # $     @#######    $ #
#          $  #     #$$$#  #
#########$    #*.**.#   $  #
        #   ### *#. #  $ $ #
        #  ##...*..##     ##
        #  $.$.# # $ $# $ # 
        #                ## 
        #   #########  ###  
        #####       ####    

; 0477_zika_8
#########            
#  . *  #  #####     
# * * * #  #   #     
#  * *  #  #. .##### 
# * * * #  # * ##..# 
# #* *# #### $$##..# 
# * * * $  $ $ $ $.##
#  . .#          $@ #
##############$  #$ #
             #   #  #
             ########

; 0477_zika_9
#######
#*@$ .#
#  * *#
#.$** #
#  *  #
#     #
#######

; 0477_zika_10
########
# *.   #
# $ #$.#
# #$.$.#
#   .$@#
# $ #$ #
#...$  #
########

; 0477_zika_11
########
#  #   #
# .. $ #
# .#.* #
# $# $ #
#    ###
# #$ #  
###  #  
# *.$#  
#  @ #  
##*$.#  
 ##  #  
  ####  

; 0477_zika_12
#########
#       #
#.$.$ $.#
# *## $##
# . .  # 
####$.$# 
##@$. .# 
## *$.$# 
##     # 
######## 

; 0477_zika_13
           ######
   #########    #
   #         .. #
#### #$#.#$###  #
# $  . * .$  ####
# #* * .$. @.#   
# $  . . * ###   
# $# #$# #  #    
#        $$ #    
##########  #    
         ####    

; 0477_zika_14
#########
#      .#
#.$.*.* #
#.$.$$$ #
#.$..+$$#
# $$$$$ #
#  . . .#
#########

; 0477_zika_15
#################
#               #
# #####  ####   #
# #   #   #     #
# # ##### ##### #
# # # . $$$   # #
# # # $*$@$** # #
# # # ..#.#.. # #
# # # $    #  # #
# # #   #  .  # #
# # ###$#$$#### #
# # # #.  .   # #
#   *   #. #  # #
# ## #########  #
#    #          #
#################

; 0477_zika_16
       #####
       #   #
       #.. #
    #### .##
   ## *   ##
  ##  *  * #
 ##  ****@ #
##    *   ##
#  *******# 
#* $  .   # 
#  #  *  ## 
# $$$#*  #  
#     ####  
#     #     
#######     

; 0477_zika_17
#######  
#  .  ###
# * *   #
# *.*$$ #
# .$*.  #
# $ @ ###
##   ##  
 #####   

; 0477_zika_18
########
#      #
# $$@* #
# .#.$##
## * .##
# . * ##
# #   ##
#.$*$*##
#     ##
########
########

; 0477_zika_19
 ####### 
 #  #  # 
 # $$$ # 
 #  #  # 
 ## # ## 
 ## # ## 
  # # #  
### # ###
#  ...  #
#  ...  #
### # ###
 #  #  # 
 # $$$ # 
 #  #@ # 
 #  #  # 
 ####### 

; 0477_zika_20
##############
#        #####
#  ###   #**##
#  #*#####**##
#  ##*########
#  ####  ### #
# ### $.   # #
# ## @*  $ # #
# ##  #.$#*# #
#####  .   # #
##**### *### #
##**# #  #*###
###########*# 
#  #**#   ### 
#  #**#     # 
############# 

; 0477_zika_21
#########   # # # ### 
# . * . #  # # # #  # 
#@*$* * # ## #   # ###
# . * . # #  $ $     #
#*******# #   $  $ $ #
# . * . # #  $ $# $ ##
# * * * # # #   #$ $##
# . * .$###  #       #
######  $     #  ##  #
     #   #$#  #####  #
     ##  . . .#  #   #
      ## . . .#  # # #
       ########  #####

; 0477_zika_22
###################  
# . $. *  $       ## 
# ** $. *     **   # 
# $. $. *  # * * # # 
# $*.* *$..* *@#*  ##
#   *$. $. * *  *#  #
# $ $ ..$$ .  **   ##
# $# *  * ..   #   # 
#    $..$ .   #   ## 
#    #  $ *      ##  
###   $#       ###   
  ###   #### ###     
    #####  ###       

; 0477_zika_23
  ######### 
 #    #   # 
#   # # $  #
#  #    #$ #
# $ #..#   #
#   *  .$$ #
# $ *$ + # #
##$.. #. .##
#  # ..#   #
#  # $$ #  #
#    #     #
######     #
     #######

; 0477_zika_24
   ##### 
 ###   ##
## . *$ #
#  *... #
# *$$$###
#  . @###
## $ .* #
 ##*$   #
  #   ###
  #####  

; 0477_zika_25
   ###     
  ## ##### 
###      ##
##  $.$ ###
 #  .$.$#  
 ##*.$. ###
  # .$.$@ #
  # .$.$. #
 ##*.$.$ ##
 #   $ $## 
 ### .  #  
   #  ###  
   ####    

