; 0531_trapdoors_1
#################
#   #  #    #   #
#   $  # $$ $   #
##$##  #    ##$##
#  ##$## ##$## # 
#  $   ..$   # # 
#  ####..#  @# # 
###  ##$###### # 
  #  $   #.... # 
  #  #   #...# ##
  ##$#####.$$$  #
  #   $    .....#
  #   ###########
  #####          

