; 0065_mario_bonenfant_collection_1
#########
#   .   #
# #$#$# #
#.# $ $ #
# $...  #
#  @#####
#####    

; 0065_mario_bonenfant_collection_2
    #####    
#####   #####
#   $.$.    #
# # $.#.$ $@#
#  $#.#.#$###
###  .$.# #  
  #   #   #  
  #########  

; 0065_mario_bonenfant_collection_3
   ######    
#####. .#####
#   $.*.    #
# # $.#.$ $@#
#  $#.#.# ###
### $.$.$ #  
  #  .#.  #  
  ###$##$##  
   #    $ ## 
   #   $#  # 
   ###     # 
    ######## 

; 0065_mario_bonenfant_collection_4
###########
#   #  #  #
#. *$$ $$ #
# #.#.@#  #
#   $$..  #
###..$..###
  #$ *# #  
  #  $  #  
  ##   ##  
   #####   

; 0065_mario_bonenfant_collection_5
  #######
  #  #  #
 ## $$$ #
## ..#@ #
# $$..  #
#..$..###
# $*# #  
#  $  #  
##   ##  
 #####   

; 0065_mario_bonenfant_collection_6
###########
#   #  #  #
#. *$$ $$ #
# #.#.@#  #
#   $$..  #
### .$..###
  #$.*# #  
  #  $  #  
  ##   ##  
   #####   

; 0065_mario_bonenfant_collection_7
######## 
#   #  # 
#.$$$*.##
# # #   #
#  .$$$.#
###..$. #
  #$.$# #
  #  @. #
  ##   ##
   ##### 

; 0065_mario_bonenfant_collection_8
  #####  
###   #  
#  .# #  
# $ #$#  
##$.  #  
#.  # #  
#.$  .###
# #*  * #
# $ #$$ #
## .@.  #
 ########

; 0065_mario_bonenfant_collection_9
 ####### 
##     ##
# .. .. #
# $$$$$ #
# #.$.###
# .$@.###
## $$   #
 #  #.  #
 ########

; 0065_mario_bonenfant_collection_10
  #####  
###   #  
#  .# #  
# $ #$#  
## .$ #  
#.  # #  
#.$$@.###
# #.  * #
# $ #$$ #
## . .  #
 ########

; 0065_mario_bonenfant_collection_11
#####         
#. .#######   
#.#..*. $@#   
# ...## $$####
# . .#  $ $  #
##*### $  $  #
 #.   $$#$ ###
 # $#   $   # 
 #  #  # #  # 
 #####     ## 
     #######  

; 0065_mario_bonenfant_collection_12
     ####   
     #  ####
  ####$. . #
### $    # #
#@ .* #    #
# #*$# .####
#  $ $  #   
## .  ###   
 ###  #     
   ####     

; 0065_mario_bonenfant_collection_13
#########
#.     .#
# ##$#  #
# #   # #
# $$ .$ #
#.# .$#.#
# $.$ $ #
# #   # #
# ##$## #
#.  @  .#
#########

; 0065_mario_bonenfant_collection_14
######   
#.   ### 
# #$   ##
#  $$.  #
##..*@# #
# $*$*  #
#.  # $##
# #.   ##
#    ####
######   

; 0065_mario_bonenfant_collection_15
 ####    
 #  #####
##.$@   #
# .$$.# #
# *.# $ #
#  . $# #
### $.  #
  #  ####
  ####   

; 0065_mario_bonenfant_collection_16
 ####      
 #  #####  
 # $$   #  
 #  ### ###
 ## $ #   #
 ## #  $# #
 #..*$#   #
 #..*   ###
 #..* # ###
##$#### $ #
# $    .. #
# @ #######
#####      

; 0065_mario_bonenfant_collection_17
       ##### 
  ######   # 
  #  $ $$ $##
  # ## # $  #
  #     $   #
  # ###$# ###
 ##.#   # #  
 #..* #   #  
 #..* # ###  
 #..* # ###  
##$####   #  
# $    .. #  
# @ #######  
#####        

; 0065_mario_bonenfant_collection_18
  #######  
###  #  ###
#  $ $ $  #
# #  .  # #
# # #.# # #
# $..+..$ #
# ##$.$## #
# #  .  # #
# ##$#$## #
#    #    #
###########

; 0065_mario_bonenfant_collection_19
  #### #####
###  ####  #
#  $     $ #
# #  ## #  #
# # #.$ $ ##
# #$#.#$# # 
# #.....# # 
# #$$.$ # # 
# # #. ## # 
# # ## ## # 
#    @    # 
#   ##  ### 
#########   

; 0065_mario_bonenfant_collection_20
  #######  
###  #  ###
#  $ $ $  #
# #  .  # #
# # #.# # #
# $..+..$ #
####$.$####
 #   .   # 
 # #$#$# # 
 #   #   # 
 ######### 

; 0065_mario_bonenfant_collection_21
            ####
#######  ####  #
#     ## #     #
# $ $  ### $ $ #
## #  $ ..# # ##
 # $ ###..  $ # 
 ###..##$##$### 
   #..$..## #   
   #  #..@..#   
####$##$##..#   
# $   .. #$ ### 
# $ $#..  $ $ # 
#    ####$$   # 
######  #   ### 
        #####   

; 0065_mario_bonenfant_collection_22
#########
#@  #   #
# # # $ #
# $.. $ #
###.#.###
# $ ..$ #
# $ # # #
#   #   #
#########

; 0065_mario_bonenfant_collection_23
#################
#   #   #   #   #
# # # $ # # # $ #
# $.. $ # $ ..$ #
###.#.#####.#.###
# $ ..$ + $.. $ #
# $ #$# # $$# # #
#   #   #   #   #
#####.#####.#####
#   #   #   #   #
# # #$$ # #$# $ #
# $ ..$ . $.. $ #
###.#.#####.#.###
# $.. $ # $ ..$ #
# $ # # # $ # # #
#   #   #   #   #
#################

; 0065_mario_bonenfant_collection_24
#############
# .  . .$ . #
# $$$$+$$$$.#
# . $.#.  . #
#############

; 0065_mario_bonenfant_collection_25
######  
#@.$.###
# *$ $ #
#.#.$  #
#      #
########

; 0065_mario_bonenfant_collection_26
     #####  
    ##   ## 
    #  $  ##
   ##.# #  #
  ##. .$ $ #
###..*..# ##
# $ ##$## # 
#  @$  $  # 
####   #### 
   #####    

; 0065_mario_bonenfant_collection_27
 ########  
 #  ##  ## 
## $$  $ ##
#...##.#  #
# .$@...# #
# #$#$#$# #
#  $      #
##  #   ###
 ########  

; 0065_mario_bonenfant_collection_28
 ########  
 #  #   ## 
## $$  $ ##
#...##.#  #
# $....@# #
# #$#$#$# #
#  $      #
##  #   ###
 ########  

; 0065_mario_bonenfant_collection_29
     #####  
  ####   ## 
 ##    $  # 
 #  ###$# # 
 # $..*.# # 
 #  # $ # ##
### #....$ #
#   #####  #
# $ @$     #
#  #########
####        

; 0065_mario_bonenfant_collection_30
     #####  
  ####   ## 
 ##    $  # 
 #  ###$# # 
 # $ ...# # 
 #  #$ *# ##
### #....  #
#   #####$ #
# $ @$     #
#  ######  #
####    ####

