; 0652_lost_rooms_1
######################################                                
##       #       #       #        +$ #                                
#  # ###   # ###   # ###   # ######  #                                
# #  *  ###  *  ###  *  ###  *  ###  #                                
# #   # ###   # ###   # ###   # ### *#                                
#  #### #  #### #  #### #  #### #  # #                                
## #  #    #  #    #  #    #  #    # #                                
#  #    #* #    #* #    #* #    #* # #                                
# ## *###  # *###  # *###  # *###  # #                                
#  ## #  * ## #  * ## #  * ## #  * # #                                
## #  # #  #  # #  #  # #  #  # #  # #                                
#  # ## #### ## #### ## #### ## #### #                                
# ## #     # #     # #     # #     # #                                
# ##  * *  #  * *  #  * *  #  * *  # #                                
#  # #### ## #### ## #### ## #### ## #                                
## # ####    ####    ####    ####    #                                
## # #################################################################
#  # ####    ####    ####    ####    ####    ####    ####    ####   ##
# ## #### ## #### ## #### ## #### ## #### ## #### ## #### ## #### #  #
# #  * *  #  * *  #  * *  #  * *  #  * *  #  * *  #  * *  #  * *  ## #
# #     # #     # #     # #     # #     # #     # #     # #     # ## #
# #### ## #### ## #### ## #### ## #### ## #### ## #### ## #### ## #  #
# #  # #  #  # #  #  # #  #  # #  #  # #  #  # #  #  # #  #  # #  # ##
# # *  # ## *  # ## *  # ## *  # ## *  # ## *  # ## *  # ## *  # ##  #
# #  ###* #  ###* #  ###* #  ###* #  ###* #  ###* #  ###* #  ###* ## #
# # *#    # *#    # *#    # *#    # *#    # *#    # *#    # *#    #  #
# #    #  #    #  #    #  #    #  #    #  #    #  #    #  #    #  # ##
# #  # ####  # ####  # ####  # ####  # ####  # ####  # ####  # ####  #
# #### #   ### #   ### #   ### #   ### #   ### #   ### #   ### #   # #
# ####  *  ###  *  ###  *  ###  *  ###  *  ###  *  ###  *  ###  *  # #
# #   ### #   ### #   ### #   ### #   ### #   ### #   ### #   ### #  #
#   #       #       #       #       #       #       #       #       ##
######################################################################

; 0652_lost_rooms_2
######################################################                
##       #       #       #       #       #        +$ #                
#  # ###   # ###   # ###   # ###   # ###   # ######  #                
# #  *  ###  *  ###  *  ###  *  ###  *  ###  *  ###  #                
# #   # ###   # ###   # ###   # ###   # ###   # ### *#                
#  #### #  #### #  #### #  #### #  #### #  #### #  # #                
## #  #    #  #    #  #    #  #    #  #    #  #    # #                
#  #    #* #    #* #    #* #    #* #    #* #    #* # #                
# ## *###  # *###  # *###  # *###  # *###  # *###  # #                
#  ## #  * ## #  * ## #  * ## #  * ## #  * ## #  * # #                
## #  # #  #  # #  #  # #  #  # #  #  # #  #  # #  # #                
#  # ## #### ## #### ## #### ## #### ## #### ## #### #                
# ## #     # #     # #     # #     # #     # #     # #                
# ##  * *  #  * *  #  * *  #  * *  #  * *  #  * *  # #                
#  # #### ## #### ## #### ## #### ## #### ## #### ## #                
## # ####    ####    ####    ####    ####    ####    #                
## # #################################################################
#  # ####    ####    ####    ####    ####    ####    ####    ####   ##
# ## #### ## #### ## #### ## #### ## #### ## #### ## #### ## #### #  #
# #  * *  #  * *  #  * *  #  * *  #  * *  #  * *  #  * *  #  * *  ## #
# #     # #     # #     # #     # #     # #     # #     # #     # ## #
# #### ## #### ## #### ## #### ## #### ## #### ## #### ## #### ## #  #
# #  # #  #  # #  #  # #  #  # #  #  # #  #  # #  #  # #  #  # #  # ##
# # *  # ## *  # ## *  # ## *  # ## *  # ## *  # ## *  # ## *  # ##  #
# #  ###* #  ###* #  ###* #  ###* #  ###* #  ###* #  ###* #  ###* ## #
# # *#    # *#    # *#    # *#    # *#    # *#    # *#    # *#    #  #
# #    #  #    #  #    #  #    #  #    #  #    #  #    #  #    #  # ##
# #  # ####  # ####  # ####  # ####  # ####  # ####  # ####  # ####  #
# #### #   ### #   ### #   ### #   ### #   ### #   ### #   ### #   # #
# ####  *  ###  *  ###  *  ###  *  ###  *  ###  *  ###  *  ###  *  # #
# #   ### #   ### #   ### #   ### #   ### #   ### #   ### #   ### #  #
#   #       #       #       #       #       #       #       #       ##
######################################################################

; 0652_lost_rooms_3
##############################################################        
##       #       #       #       #       #       #        +$ #        
#  # ###   # ###   # ###   # ###   # ###   # ###   # ######  #        
# #  *  ###  *  ###  *  ###  *  ###  *  ###  *  ###  *  ###  #        
# #   # ###   # ###   # ###   # ###   # ###   # ###   # ### *#        
#  #### #  #### #  #### #  #### #  #### #  #### #  #### #  # #        
## #  #    #  #    #  #    #  #    #  #    #  #    #  #    # #        
#  #    #* #    #* #    #* #    #* #    #* #    #* #    #* # #        
# ## *###  # *###  # *###  # *###  # *###  # *###  # *###  # #        
#  ## #  * ## #  * ## #  * ## #  * ## #  * ## #  * ## #  * # #        
## #  # #  #  # #  #  # #  #  # #  #  # #  #  # #  #  # #  # #        
#  # ## #### ## #### ## #### ## #### ## #### ## #### ## #### #        
# ## #     # #     # #     # #     # #     # #     # #     # #        
# ##  * *  #  * *  #  * *  #  * *  #  * *  #  * *  #  * *  # #        
#  # #### ## #### ## #### ## #### ## #### ## #### ## #### ## #        
## # ####    ####    ####    ####    ####    ####    ####    #        
## # #################################################################
#  # ####    ####    ####    ####    ####    ####    ####    ####   ##
# ## #### ## #### ## #### ## #### ## #### ## #### ## #### ## #### #  #
# #  * *  #  * *  #  * *  #  * *  #  * *  #  * *  #  * *  #  * *  ## #
# #     # #     # #     # #     # #     # #     # #     # #     # ## #
# #### ## #### ## #### ## #### ## #### ## #### ## #### ## #### ## #  #
# #  # #  #  # #  #  # #  #  # #  #  # #  #  # #  #  # #  #  # #  # ##
# # *  # ## *  # ## *  # ## *  # ## *  # ## *  # ## *  # ## *  # ##  #
# #  ###* #  ###* #  ###* #  ###* #  ###* #  ###* #  ###* #  ###* ## #
# # *#    # *#    # *#    # *#    # *#    # *#    # *#    # *#    #  #
# #    #  #    #  #    #  #    #  #    #  #    #  #    #  #    #  # ##
# #  # ####  # ####  # ####  # ####  # ####  # ####  # ####  # ####  #
# #### #   ### #   ### #   ### #   ### #   ### #   ### #   ### #   # #
# ####  *  ###  *  ###  *  ###  *  ###  *  ###  *  ###  *  ###  *  # #
# #   ### #   ### #   ### #   ### #   ### #   ### #   ### #   ### #  #
#   #       #       #       #       #       #       #       #       ##
######################################################################

