; 0419_nakamiya_practice_1
   #### 
 ###@ ##
##  $$ #
# $    #
#... ###
######  

; 0419_nakamiya_practice_2
######
#    #
#.  .#
#$$$$#
#.  .#
#  @ #
######

; 0419_nakamiya_practice_3
#########
#   #   #
#   # $ #
# . # $ #
# .    ##
# . # $ #
# . #$$ #
# . #  @#
#########

; 0419_nakamiya_practice_4
##########
#  #     #
#  #     #
#  ##$$$##
#        #
#...#@#  #
##########

; 0419_nakamiya_practice_5
  ##### 
  #   # 
### #$##
#. $ $ #
#.    @#
#.######
###     

; 0419_nakamiya_practice_6
####      
#  #######
#  $ $ $ #
#...    @#
##########

; 0419_nakamiya_practice_7
#########
#   #   #
# $.#.$ #
# $.@.$ #
# $.#.$ #
#   #   #
#########

; 0419_nakamiya_practice_8
######    
#.$  ##   
#. $  ##  
#.# $  ## 
#.## $  ##
#.@## $  #
######   #
     #####

; 0419_nakamiya_practice_9
#########
# #     #
# ....# #
#       #
## ### ##
#       #
# #$$$$ #
#     #@#
#########

; 0419_nakamiya_practice_10
 #########
 #  #    #
 #  @ $# #
##  # $  #
#   # $# #
#...##   #
##########

; 0419_nakamiya_practice_11
########
#. #   #
#.   $ #
#. $#$ #
#. $  @#
########

; 0419_nakamiya_practice_12
 ##########
 #@  ##   #
 # $ $  # #
###$##  # #
#..  #  $ #
#..  #    #
#  ########
####       

