; 0367_microban_01_arranged_1
  #####      
  #   #      
  # # #######
  #  *  #   #
  ## ##   # #
  #   * #*  #
### # # # ###
#  *#$+   #  
# #   ## ##  
#   #  *  #  
####### # #  
      #   #  
      #####  

; 0367_microban_01_arranged_2
   #####   
   # @ #   
  ##   ##  
###.$$$.###
#  $...$  #
#  $.#.$  #
#  $.*.$  #
###.$$$.###
  ## . ##  
   #   #   
   #####   

; 0367_microban_01_arranged_3
 ####### 
##  .  ##
# .$$$. #
# $ + $ #
#.$.*.$.#
# $ . $ #
# .$$$. #
##  .  ##
 ####### 

