; 0070_aruba_01_1
#########
####.####
#  * *  #
#  ...  #
###.#.###
#  .#.  #
#   #   #
# $###$ #
#   $   #
#  $#$  #
# $ $ $ #
##  @  ##
#########

; 0070_aruba_01_2
#########
#       #
# $..$# #
# #.$.$ #
# $..$@ #
# #.$.$ #
# $..$# #
#       #
#########

; 0070_aruba_01_3
#########
#       #
#  ..*  #
#  * $  #
# $.$   #
# $+$   #
#  * $  #
#  ..*  #
#       #
#########

; 0070_aruba_01_4
#########
#       #
# $..$$ #
# #.$.  #
# $.#+$ #
# #.$.  #
# $..$$ #
#       #
#########

; 0070_aruba_01_5
#############
#           #
#  ... ...  #
#  *$$ $.$  #
# $*+$ $*$$ #
#  *$$ $.$  #
#  ...  .   #
#           #
#############

; 0070_aruba_01_6
##########
#        #
# $.$$.$ #
#  .* .  #
# @. *.  #
# $.$$.$ #
#        #
##########

; 0070_aruba_01_7
#########
#       #
# $.*.$ #
#  .$.$ #
# #.*@# #
# $.$.  #
# $.$.$ #
#       #
#########

; 0070_aruba_01_8
########
#      #
# $..$ #
# .  . #
# $+$$ #
# $$.$ #
# .  . #
# $..$ #
#      #
########

; 0070_aruba_01_9
#########
#       #
# .*.*. #
# .$.$. #
#  $.$  #
# $$.$$ #
#   @   #
#########

; 0070_aruba_01_10
#########
#       #
# .$$$. #
#  .$.  #
# .$@$. #
# $...$ #
#  $.$  #
#       #
#########

