; 0311_orimaze_1
#####################
#                   #
# ## ########### ## #
# # * * * * * $ . # #
#   # #   #  .# #$  #
# #  @  #####     # #
# #$# #.  #  $# #*# #
# #   $ * * * .   # #
# #* # *#####* # *# #
# #  #  #   #  #  # #
# #*###*#   #*###*# #
# #  #  #   #  #  # #
# #* # *#####* # *# #
# # $   * * * .   # #
# #.# #*  #   # #*# #
# #     #####     # #
#  *# #$  #   # #.  #
# #   . * * * * $ # #
# ## ########### ## #
#                   #
#####################

; 0311_orimaze_2
#####################
#                   #
# ## ########### ## #
# # * * * * * *   # #
#   # #   #   # #*  #
# #     #####  @  # #
# #$# #*  #  *# # # #
# #     * * *   * # #
# #* # *#####* # *# #
# #  #  #   #  #  # #
# #*###*#   #*###*# #
# #  #  #   #  #  # #
# #* # *#####* # *# #
# #   $ * * *   . # #
# #*# #.  #  *# #$# #
# #     #####     # #
#  .# #$  #   # #.  #
# #   . * * * * $ # #
# ## ########### ## #
#                   #
#####################

; 0311_orimaze_3
#####################
#                   #
# ## ########### ## #
# # $ * * * * * . # #
#  .# #   #   # #$  #
# #     #####  @  # #
# #*# #$  #  *# # # #
# #   . * * *   $ # #
# #* # *#####* # *# #
# #  #  #   #  #  # #
# #*###*#   #*###*# #
# #  #  #   #  #  # #
# #* # *#####* # *# #
# # . * * * * $   # #
# #$# #   #  .# #*# #
# #     #####     # #
#   # #.  #  $# #.  #
# # *   * * * . $ # #
# ## ########### ## #
#                   #
#####################

; 0311_orimaze_4
#####################
#                   #
# ## ########### ## #
# # * * * * * $ . # #
#   # #   #  .# #$  #
# #     #####  @  # #
# # # #.  #  $# #*# #
# # * $ * * * .   # #
# #* # *#####* # *# #
# #  #  #   #  #  # #
# #*###*#   #*###*# #
# #  #  #   #  #  # #
# #* # *#####* # *# #
# # $   * * * .   # #
# # # #*  #   # #*# #
# #     #####     # #
#  *# #$  #   # #.  #
# #   . * * * * $ # #
# ## ########### ## #
#                   #
#####################

; 0311_orimaze_5
#####################
#                   #
# ## ########### ## #
# # $ * * * * * . # #
#  .# #   #   # #$  #
# #     #####  @  # #
# #$# #*  #  $# #.# #
# # .   * * *   $ # #
# #* # *#####* # *# #
# #  #  #   #  #  # #
# #*###*#   #*###*# #
# #  #  #   #  #  # #
# #* # *#####* # *# #
# # $   * * *   . # #
# #.# #*  #  .# #$# #
# #     #####     # #
#  $# #   #   # #.  #
# # . * * * * * $ # #
# ## ########### ## #
#                   #
#####################

