; 0299_handmade_1
    ####      
    #  ####   
    #     #   
 #### ##  #   
 #  #  # #####
 #     #     #
## #####  #  #
# +#  ##### ##
# $   #     # 
##### #  #  # 
   #  ## #### 
   #     #    
   ####  #    
      ####    

; 0299_handmade_2
 #####    
 #   #####
 # $ #   #
 #  .* $ #
###*##.  #
#  .##*###
# $ *.  # 
#  @# $ # 
#####   # 
    ##### 

; 0299_handmade_3
 #####            
 #   #########    
 # # #       #####
 #  *  # # # #   #
### ##.  #  *  # #
#  *##$####$##*  #
# #  *  #  +## ###
#   # # # #  *  # 
#####   #   # # # 
    ## ######   # 
    ## ##   ##### 
#####   #####   # 
#   # #     # # # 
# #  *  # #. *  # 
#  *##.##  $## ###
### ##$  ## ##*  #
 #  *  # #  *  # #
 # # #   # # #   #
 #   #####   #####
 #####   #####    

; 0299_handmade_4
##########   ##########
#        #   #        #
# # ## # ## ## # ## # #
#  $.#  $.# #.$  #.$  #
## # ## # ### # ## # ##
 #.$  #.$  #  $.#  $.# 
 ## # ## # # # ## # ## 
  #   ##       ##   #  
  ### ########### ###  
  #   ##   #.  ##   #  
 ## # ## # $  ### # ## 
 #.$  #.$  # @$.#  $.# 
## # ## # ### # ## # ##
#  $.#  $.# #.$  #.$  #
# # ## # ## ## # ## # #
#        #   #        #
##########   ##########

; 0299_handmade_5
       #####          
       #   #          
       # # ##         
       #   .#####     
       ##$#     #     
        # ##### ##    
        # #   #  #    
       ## # # ## #####
       #  #  $.# #   #
      ## ### #     # #
     ##   #  #####$  #
  ####  #  .###   .###
###.   ### $ #  ####  
#  $#####  #   ##     
# #     # ### ##      
#   # #.$  #  #       
##### ## # # ##       
    #  #   # #        
    ## ##### #        
     #@    # ##       
     #####.$  #       
         ## # #       
          #   #       
          #####       

; 0299_handmade_6
    ####        
    #  ####     
    #     #     
    # $## #     
    ##. # ######
 ###### # ##   #
 #    @$. #.$  #
 # ###.##$  # ##
## #  $##.### # 
#  $.# .$     # 
#   ## # ###### 
###### # .##    
     # ##$ #    
     #     #    
     ####  #    
        ####    

