; 0869_nanajyang_1
########  
#   #  ###
# ..$$   #
###+#  # #
  # . $$ #
  ###  ###
    ####  

; 0869_nanajyang_2
                          #####           
                          #***#           
                       ####***#           
                      #####***#           
                     ##########           
                   #####                  
                   #####                  
                   ####                   
          ####     ####     ####          
       ####..##### #### #####..###        
     ##     $.##############.  $ ####     
    ## $ ##$$.##############.       ##    
   ## $  #   ################$$$## $ ##   
   #  $ #  ##  ############ $ # ##  $ #   
  ##   #  #  . #   ####   # .   ###  $ #  
  ## $## #  #  #        $ #$$#     #  $#  
  ##  ##   ##$##### $  $ #   $ # $ # $ #  
 ## $#  ###        #$ ###    $   $  #$ ## 
 ##  $  ##  ###### #  # $$#####  $  #   # 
 #   #  #  #.*...# ## # $ ...*.# $ $#   # 
 # ### ##$#......    $#  ....*..# $  #  # 
 # #   #  *..##**#$#  #  **.##..#  $ #$ # 
## # #$   #**##..# # $####..##.*#  $ #  ##
#  $    # #...*..# #   ###..*...#$####  ##
# #$###   #...*..# # @ $ ##.*... $ ###  ##
#   ##### ######## ### # ##$#####$ ###  ##
###$####            ##   ##         ##  ##
#    #     ######   ##$###.  ###### ######
#    # #####....#####....#####    # #    #
## ###  $ $ $.*  .*.$ *.$ .*.$ $ $  #   # 
 #   #   $ $ *.$ *.* $.*  *.* $ $   #   # 
 # $$#  $ $ $.*  .*.$ *.$ .*.$ $ $ #    # 
 #    #  $ $ *.$ *.* $.*  *.* $ $  #    # 
 ## $$ #  $ $.*  .*.$ *.$ .*.$ $  #    ## 
  #    #   $ *.$ *.* $.*  *.* $   #    #  
  ## $$ #   ####..*..####..*..####    ##  
   #   $#####  ################      ##   
    #  $ $  $$    ######            ##    
     #   $    $   ######          ###     
      #####     #########      ####       
          ########      ########          

