; 0417_nakamiya_joy_1
 ###########
 #  #  # @ #
 #  .$ #   #
 #  #. # $##
##$ # .#  # 
#   # $.  # 
#   #  #  # 
########### 

; 0417_nakamiya_joy_2
##########
# @*   * #
#*$ # #  #
#       *#
#* #.#   #
#       *#
# * * *  #
##########

; 0417_nakamiya_joy_3
###########
#  ....   #
# $.*.*  ##
##$#####  #
#    $    #
#  $ $ $  #
#  *****#@#
###########

; 0417_nakamiya_joy_4
 ######### 
## .   . ##
# $*$ $*$ #
#  .....$@#
# $*$ $*$ #
## .   . ##
 ######### 

; 0417_nakamiya_joy_5
################
#      @# .   ##
# #$#$ # *   $.#
# $ ..# *  # # #
# #. # *  #   ##
# $.# *  # # $.#
#  # $  # #  # #
# #  # # # #  ##
#            $.#
##$ #$ #$ #$ # #
# .# .# .# .# ##
################

; 0417_nakamiya_joy_6
 ######
 #    #
 # *$ #
##.@.##
# $* # 
#    # 
###### 

; 0417_nakamiya_joy_7
#########
# . . . #
# $ $ $ #
##  .####
# $$$ $ #
#@. . . #
#########

; 0417_nakamiya_joy_8
  ####   
###  ####
#  . .  #
# $ $ $ #
##.#*#.##
# $ $ $ #
#  .@.  #
#########

