; 1003_6_boxes_1
#####   
#   ####
# $    #
# $#*.$#
#  #   #
#  +**.#
####   #
   #####

