; 0996_5_boxes_1
########
#    ###
# .$.$ #
#@$*.$.#
###    #
#####  #
########

; 0996_5_boxes_2
  ##### 
###@  # 
#  $#.##
# $ *. #
#  $$. #
## # . #
 #   ###
 #####  

; 0996_5_boxes_3
  ##### 
###   # 
# $@#.##
#  $   #
# *. . #
##.#$$ #
 #   ###
 #####  

