; 0644_rooms_1
###################################
#    ####      ####      ####     #
# ## #### #### #### #### #### ### #
# #  * *  ###  * *  ###  * *  #   #
# #     # ###     # ###     # # ###
# ##### # ####### # ####### # # ###
# #   # # ###   # # ###   # # #   #
# # #*  # ### #*  # ### #*  # ### #
# #   ###* ##   ###* ##   ###* #  #
# #  *#    ##  *#    ##  *#    # ##
# # #   #  ## #   #  ## #   #  #  #
# #   # #####   # #####   # ##### #
# ##### #   ##### #   ##### #   # #
# #   #  *  #   #  *  #   #  *  # #
#  *  #### ## # #### ## # #### ## #
#### $+       #         #         #
###################################

; 0644_rooms_2
###################################
#    ######    ######    ######   #
# ## ####   ## ####   ## ####   # #
# #  * *  ###  * *  ###  * *  ### #
# #     # ###     # ###     # #   #
# ##### # ####### # ####### # # ###
# #   # # ###   # # ###   # # #   #
# # #*  # ### #*  # ### #*  # ### #
# #   ###* ##   ###* ##   ###* #  #
# #  *#    ##  *#    ##  *#    # ##
# # #   #  ## #   #  ## #   #  #  #
# #   # #####   # #####   # ##### #
# ##### #   ##### #   ##### #   # #
# #   #  *  #   #  *  #   #  *  # #
#  *  #### ## # #### ## # #### ## #
#### $+       #         #         #
###################################
                                   

; 0644_rooms_3
######################################################################
#    ####    ####    ####    ####    ####    ####    ####    ####   ##
# ## #### ## #### ## #### ## #### ## #### ## #### ## #### ## #### #  #
# #  * *  #  * *  #  * *  #  * *  #  * *  #  * *  #  * *  #  * *  ## #
# #     # #     # #     # #     # #     # #     # #     # #     # ## #
# #### ## #### ## #### ## #### ## #### ## #### ## #### ## #### ## #  #
# #  # #  #  # #  #  # #  #  # #  #  # #  #  # #  #  # #  #  # #  # ##
# # *  # ## *  # ## *  # ## *  # ## *  # ## *  # ## *  # ## *  # ##  #
# #  ###* #  ###* #  ###* #  ###* #  ###* #  ###* #  ###* #  ###* ## #
# # *#    # *#    # *#    # *#    # *#    # *#    # *#    # *#    #  #
# #    #  #    #  #    #  #    #  #    #  #    #  #    #  #    #  # ##
# #  # ####  # ####  # ####  # ####  # ####  # ####  # ####  # ####  #
#* ### #   ### #   ### #   ### #   ### #   ### #   ### #   ### #   # #
#  ###  *  ###  *  ###  *  ###  *  ###  *  ###  *  ###  *  ###  *  # #
#  ###### #   ### #   ### #   ### #   ### #   ### #   ### #   ### #  #
# $+        #       #       #       #       #       #       #       ##
######################################################################
                                                                      

; 0644_rooms_4
##############                                                        
##        +$ #                                                        
#  # ######  #                                                        
# #  *  ###  #                                                        
# #   # ### *#                                                        
#  #### #  # #                                                        
## #  #    # #                                                        
#  #    #* # #                                                        
# ## *###  # #                                                        
#  ## #  * # #                                                        
## #  # #  # #                                                        
#  # ## #### #                                                        
# ## #     # #                                                        
# ##  * *  # #                                                        
#  # #### ## #                                                        
## # ####    #                                                        
## # #################################################################
#  # ####    ####    ####    ####    ####    ####    ####    ####   ##
# ## #### ## #### ## #### ## #### ## #### ## #### ## #### ## #### #  #
# #  * *  #  * *  #  * *  #  * *  #  * *  #  * *  #  * *  #  * *  ## #
# #     # #     # #     # #     # #     # #     # #     # #     # ## #
# #### ## #### ## #### ## #### ## #### ## #### ## #### ## #### ## #  #
# #  # #  #  # #  #  # #  #  # #  #  # #  #  # #  #  # #  #  # #  # ##
# # *  # ## *  # ## *  # ## *  # ## *  # ## *  # ## *  # ## *  # ##  #
# #  ###* #  ###* #  ###* #  ###* #  ###* #  ###* #  ###* #  ###* ## #
# # *#    # *#    # *#    # *#    # *#    # *#    # *#    # *#    #  #
# #    #  #    #  #    #  #    #  #    #  #    #  #    #  #    #  # ##
# #  # ####  # ####  # ####  # ####  # ####  # ####  # ####  # ####  #
# #### #   ### #   ### #   ### #   ### #   ### #   ### #   ### #   # #
# ####  *  ###  *  ###  *  ###  *  ###  *  ###  *  ###  *  ###  *  # #
# #   ### #   ### #   ### #   ### #   ### #   ### #   ### #   ### #  #
#   #       #       #       #       #       #       #       #       ##
######################################################################

; 0644_rooms_5
######################                                                
##       #        +$ #                                                
#  # ###   # ######  #                                                
# #  *  ###  *  ###  #                                                
# #   # ###   # ### *#                                                
#  #### #  #### #  # #                                                
## #  #    #  #    # #                                                
#  #    #* #    #* # #                                                
# ## *###  # *###  # #                                                
#  ## #  * ## #  * # #                                                
## #  # #  #  # #  # #                                                
#  # ## #### ## #### #                                                
# ## #     # #     # #                                                
# ##  * *  #  * *  # #                                                
#  # #### ## #### ## #                                                
## # ####    ####    #                                                
## # #################################################################
#  # ####    ####    ####    ####    ####    ####    ####    ####   ##
# ## #### ## #### ## #### ## #### ## #### ## #### ## #### ## #### #  #
# #  * *  #  * *  #  * *  #  * *  #  * *  #  * *  #  * *  #  * *  ## #
# #     # #     # #     # #     # #     # #     # #     # #     # ## #
# #### ## #### ## #### ## #### ## #### ## #### ## #### ## #### ## #  #
# #  # #  #  # #  #  # #  #  # #  #  # #  #  # #  #  # #  #  # #  # ##
# # *  # ## *  # ## *  # ## *  # ## *  # ## *  # ## *  # ## *  # ##  #
# #  ###* #  ###* #  ###* #  ###* #  ###* #  ###* #  ###* #  ###* ## #
# # *#    # *#    # *#    # *#    # *#    # *#    # *#    # *#    #  #
# #    #  #    #  #    #  #    #  #    #  #    #  #    #  #    #  # ##
# #  # ####  # ####  # ####  # ####  # ####  # ####  # ####  # ####  #
# #### #   ### #   ### #   ### #   ### #   ### #   ### #   ### #   # #
# ####  *  ###  *  ###  *  ###  *  ###  *  ###  *  ###  *  ###  *  # #
# #   ### #   ### #   ### #   ### #   ### #   ### #   ### #   ### #  #
#   #       #       #       #       #       #       #       #       ##
######################################################################

; 0644_rooms_6
##############################                                        
##       #       #        +$ #                                        
#  # ###   # ###   # ######  #                                        
# #  *  ###  *  ###  *  ###  #                                        
# #   # ###   # ###   # ### *#                                        
#  #### #  #### #  #### #  # #                                        
## #  #    #  #    #  #    # #                                        
#  #    #* #    #* #    #* # #                                        
# ## *###  # *###  # *###  # #                                        
#  ## #  * ## #  * ## #  * # #                                        
## #  # #  #  # #  #  # #  # #                                        
#  # ## #### ## #### ## #### #                                        
# ## #     # #     # #     # #                                        
# ##  * *  #  * *  #  * *  # #                                        
#  # #### ## #### ## #### ## #                                        
## # ####    ####    ####    #                                        
## # #################################################################
#  # ####    ####    ####    ####    ####    ####    ####    ####   ##
# ## #### ## #### ## #### ## #### ## #### ## #### ## #### ## #### #  #
# #  * *  #  * *  #  * *  #  * *  #  * *  #  * *  #  * *  #  * *  ## #
# #     # #     # #     # #     # #     # #     # #     # #     # ## #
# #### ## #### ## #### ## #### ## #### ## #### ## #### ## #### ## #  #
# #  # #  #  # #  #  # #  #  # #  #  # #  #  # #  #  # #  #  # #  # ##
# # *  # ## *  # ## *  # ## *  # ## *  # ## *  # ## *  # ## *  # ##  #
# #  ###* #  ###* #  ###* #  ###* #  ###* #  ###* #  ###* #  ###* ## #
# # *#    # *#    # *#    # *#    # *#    # *#    # *#    # *#    #  #
# #    #  #    #  #    #  #    #  #    #  #    #  #    #  #    #  # ##
# #  # ####  # ####  # ####  # ####  # ####  # ####  # ####  # ####  #
# #### #   ### #   ### #   ### #   ### #   ### #   ### #   ### #   # #
# ####  *  ###  *  ###  *  ###  *  ###  *  ###  *  ###  *  ###  *  # #
# #   ### #   ### #   ### #   ### #   ### #   ### #   ### #   ### #  #
#   #       #       #       #       #       #       #       #       ##
######################################################################

; 0644_rooms_7
##############################################                        
##       #       #       #       #        +$ #                        
#  # ###   # ###   # ###   # ###   # ######  #                        
# #  *  ###  *  ###  *  ###  *  ###  *  ###  #                        
# #   # ###   # ###   # ###   # ###   # ### *#                        
#  #### #  #### #  #### #  #### #  #### #  # #                        
## #  #    #  #    #  #    #  #    #  #    # #                        
#  #    #* #    #* #    #* #    #* #    #* # #                        
# ## *###  # *###  # *###  # *###  # *###  # #                        
#  ## #  * ## #  * ## #  * ## #  * ## #  * # #                        
## #  # #  #  # #  #  # #  #  # #  #  # #  # #                        
#  # ## #### ## #### ## #### ## #### ## #### #                        
# ## #     # #     # #     # #     # #     # #                        
# ##  * *  #  * *  #  * *  #  * *  #  * *  # #                        
#  # #### ## #### ## #### ## #### ## #### ## #                        
## # ####    ####    ####    ####    ####    #                        
## # #################################################################
#  # ####    ####    ####    ####    ####    ####    ####    ####   ##
# ## #### ## #### ## #### ## #### ## #### ## #### ## #### ## #### #  #
# #  * *  #  * *  #  * *  #  * *  #  * *  #  * *  #  * *  #  * *  ## #
# #     # #     # #     # #     # #     # #     # #     # #     # ## #
# #### ## #### ## #### ## #### ## #### ## #### ## #### ## #### ## #  #
# #  # #  #  # #  #  # #  #  # #  #  # #  #  # #  #  # #  #  # #  # ##
# # *  # ## *  # ## *  # ## *  # ## *  # ## *  # ## *  # ## *  # ##  #
# #  ###* #  ###* #  ###* #  ###* #  ###* #  ###* #  ###* #  ###* ## #
# # *#    # *#    # *#    # *#    # *#    # *#    # *#    # *#    #  #
# #    #  #    #  #    #  #    #  #    #  #    #  #    #  #    #  # ##
# #  # ####  # ####  # ####  # ####  # ####  # ####  # ####  # ####  #
# #### #   ### #   ### #   ### #   ### #   ### #   ### #   ### #   # #
# ####  *  ###  *  ###  *  ###  *  ###  *  ###  *  ###  *  ###  *  # #
# #   ### #   ### #   ### #   ### #   ### #   ### #   ### #   ### #  #
#   #       #       #       #       #       #       #       #       ##
######################################################################

; 0644_rooms_8
######################################################################
##       #       #       #       #       #       #       #        +$ #
#  # ###   # ###   # ###   # ###   # ###   # ###   # ###   # ######  #
# #  *  ###  *  ###  *  ###  *  ###  *  ###  *  ###  *  ###  *  ###  #
# #   # ###   # ###   # ###   # ###   # ###   # ###   # ###   # ### *#
#  #### #  #### #  #### #  #### #  #### #  #### #  #### #  #### #  # #
## #  #    #  #    #  #    #  #    #  #    #  #    #  #    #  #    # #
#  #    #* #    #* #    #* #    #* #    #* #    #* #    #* #    #* # #
# ## *###  # *###  # *###  # *###  # *###  # *###  # *###  # *###  # #
#  ## #  * ## #  * ## #  * ## #  * ## #  * ## #  * ## #  * ## #  * # #
## #  # #  #  # #  #  # #  #  # #  #  # #  #  # #  #  # #  #  # #  # #
#  # ## #### ## #### ## #### ## #### ## #### ## #### ## #### ## #### #
# ## #     # #     # #     # #     # #     # #     # #     # #     # #
# ##  * *  #  * *  #  * *  #  * *  #  * *  #  * *  #  * *  #  * *  # #
#  # #### ## #### ## #### ## #### ## #### ## #### ## #### ## #### ## #
## # ####    ####    ####    ####    ####    ####    ####    ####    #
## # #################################################################
#  # ####    ####    ####    ####    ####    ####    ####    ####   ##
# ## #### ## #### ## #### ## #### ## #### ## #### ## #### ## #### #  #
# #  * *  #  * *  #  * *  #  * *  #  * *  #  * *  #  * *  #  * *  ## #
# #     # #     # #     # #     # #     # #     # #     # #     # ## #
# #### ## #### ## #### ## #### ## #### ## #### ## #### ## #### ## #  #
# #  # #  #  # #  #  # #  #  # #  #  # #  #  # #  #  # #  #  # #  # ##
# # *  # ## *  # ## *  # ## *  # ## *  # ## *  # ## *  # ## *  # ##  #
# #  ###* #  ###* #  ###* #  ###* #  ###* #  ###* #  ###* #  ###* ## #
# # *#    # *#    # *#    # *#    # *#    # *#    # *#    # *#    #  #
# #    #  #    #  #    #  #    #  #    #  #    #  #    #  #    #  # ##
# #  # ####  # ####  # ####  # ####  # ####  # ####  # ####  # ####  #
# #### #   ### #   ### #   ### #   ### #   ### #   ### #   ### #   # #
# ####  *  ###  *  ###  *  ###  *  ###  *  ###  *  ###  *  ###  *  # #
# #   ### #   ### #   ### #   ### #   ### #   ### #   ### #   ### #  #
#   #       #       #       #       #       #       #       #       ##
######################################################################

