; 0642_lexical_catalysts_01-2_1
#######################
#                     #
# *** * * **  *** * * #
# * * * *   *  *  * * #
# * * * * * *# *# * * #
# * * * * **   *  * * #
# $ * *** * * *** **. #
#   #  #    #  #    #@#
#######################

