; 0518_longevity_1
 ### ########################### 
#...#...........................#
#...# $ $ $ $ $ $ $ $ $ $ $ $ * #
#...# $$$$$$$$$$$$$$$$$$$$$$#$$$#
#...#                       #   #
#...# $$$$$$$$$$$$$$$$$$$$$$#   #
#...#                       #   #
#...# $$$$$$$$$$$$$$$$$$$$$$#   #
#...#                       #   #
#...# $$$$$$$$$$$$$$$$$$$$$$#   #
#...#                       #   #
#...# $$$$$$$$$$$$$$$$$$$$$$#   #
#...#                       #   #
#...# $$$$$$$$$$$$$$$$$$$$$$#   #
#...#                       #   #
#...# $$$$$$$$$$$$$$$$$$$$$$#   #
#...#                       #...#
#...# $$$$$$$$$$$$$$$$$$$$$$#...#
#...#                      @#...#
#....#######################....#
#...............................#
#...............................#
#...............................#
 ############################### 

; 0518_longevity_2
 ### ########################### 
#...# $ $ $ $ $ $ $ $ $.........#
#.... $ $ $ $ $ $ $ $ $.........#
#...#.................*.........#
#...#...........................#
#...#...........................#
#...#...........................#
#***#...........................#
#   #...........................#
#  $############################ 
#$  $                          @#
# $ $ $$$ $$$$$$$$$$$$$$$$$$$$$ #
# $$$$$ $ $                   $ #
# $     $ $ $$$$$ $ $$$ $$$ $ $ #
# $$$ $$$ $ $   $ $ $ $ $ $$$ $ #
#  $  $   $ $$$ $ $$$ $$$ $   $ #
# $$$ $ $$$   $ $         $$$ $ #
#   $ $ $  $  $ $$$$$$$$$   $ $ #
# $$$ $ $$ $  $ $   $   $$$$$ $ #
# $   $  $ $ $$ $$$ $$$ $ $   $ #
# $ $ $$$$ $ $                $ #
# $$$ $ $  $$$$$$$$$$$$$$$$$$$$ #
#                               #
 ############################### 

; 0518_longevity_3
 ############################################################### 
#      .                                                 .      #
# $ $ $ * $ $ $ $ * * * * * * *   * * * * * * * $ $ $ $ * $ $ $ #
#  $ $ $ * $ $ $ $ * * * * * * * * * * * * * * $ $ $ $ * $ $ $  #
# $ $ $ $ * $ $ $ $ * * * * * *   * * * * * * $ $ $ $ * $ $ $ $ #
#  $ $ $ $ * $ $ $ $ * * * * * * * * * * * * $ $ $ $ * $ $ $ $  #
# $ $ $ $ $ * $ $ $ $ * * * * *   * * * * * $ $ $ $ * $ $ $ $ $ #
#  $ $ $ $ $ * $ $ $ $ * * * * * * * * * * $ $ $ $ * $ $ $ $ $  #
# $ $ $ $ $ $ * $ $ $ $ * $ * *   * * $ * $ $ $ $ * $ $ $ $ $ $ #
#  $ $ $ $ $ $ * $ $ $ $ $ $ * * * * $ $ $ $ $ $ * $ $ $ $ $ $  #
# $ $ $ $ $ $ $ * $ $ $ $ * $ *   * $ * $ $ $ $ * $ $ $ $ $ $ $ #
#  $ $ $ $ $ $ $ * $ $ $ * * $ * * $ * * $ $ $ * $ $ $ $ $ $ $  #
# $ $ $ $ $ $ $ $ * $ $ * $ * $   $ * $ * $ $ * $ $ $ $ $ $ $ $ #
#  $ $ $ $ $ $ $ $ * $ * $ $ * $ $ * $ $ * $ * $ $ $ $ $ $ $ $  #
# $ $ $ $ $ $ $ $ $ * * $ # $ *   * $ # $ * * $ $ $ $ $ $ $ $ $ #
#  $ $ $ $ $ $ $ $ $ * $ #.# $ * * $ #.# $ * $ $ $ $ $ $ $ $ $  #
# $ $ $ $ $ $ $ $ $ $ $ #...# *   * #...# $ $ $ $ $ $ $ $ $ $ $ #
#  $ $ $ $ $ $ $ $ $ $ #.....# * * #.....# $ $ $ $ $ $ $ $ $ $  #
# $ $ $ $ $ $ $ $ $ $ #.......#   #.......# $ $ $ $ $ $ $ $ $ $ #
#  $ $ $ $ $ $ $ $ $ #.........# #.........# $ $ $ $ $ $ $ $ $  #
# $ $ $ $ $ $ $ $ $ #.......... . ..........# $ $ $ $ $ $ $ $ $ #
#  $ $ $ $ $ $ $ $ #...........$.$...........# $ $ $ $ $ $ $ $  #
# $ $ $ $ $ $ $ $ #............ . ............# $ $ $ $ $ $ $ $ #
#  $ $ $ $ $ $ $ #.........#.........#.........# $ $ $ $ $ $ $  #
# $ $ $ $ $ $ $ #.........#.#.......#.#.........# $ $ $ $ $ $ $ #
#  $ $ $ $ $ $ #.........#...#.....#...#.........# $ $ $ $ $ $  #
# $ $ $ $ $ $ #.........#.....#...#.....#.........# $ $ $ $ $ $ #
#  $ $ $ $ $ #.........#.......#.#.......#.........# $ $ $ $ $  #
# $ $ $ $ $ #.........#........ . ........#.........# $ $ $ $ $ #
#  $ $ $ $ #.........#.........$+$.........#.........# $ $ $ $  #
# $ $ $ $ #.........#.......... . ..........#.........# $ $ $ $ #
#  $ $ $ #.........#.........................#.........# $ $ $  #
# $ $ $ #.........#...........................#.........# $ $ $ #
#      #.........#.............................#.........#      #
 ###### ######### ############################# ######### ###### 

; 0518_longevity_4
 ######################################################################### 
#                                                                         #
#     ...     ...........  .......  $$$    $$  $$$    $$  $$$             #
#    .. ..         .       .     . $$ $$    $$$$ $$    $$$$ $$       $$$  #
#   ..   ..   $$$  .       .     . $     $    $     $    $     $    $   $ #
#   .     .  $   $ .       .     . $$   $  $  $$   $  $  $$   $  $  $$ $$ #
#  ..     .. $$ $$ .  $$$  .     .  $  $  $    $  $  $    $  $  $   $   $ #
#  .       . $   $ . $   $ ....... $$ $  $  $ $$ $  $  $ $$ $  $  $  $$$  #
# ..       .. $$$  . $$ $$ .            $  $       $  $       $  $        #
# ...........      . $   $ .  $$$   $$$   $    $$$   $    $$$   $   $$$   #
# .         .      .  $$$  . $   $ $   $ $    $   $ $    $   $ $   $   $  #
# .         .      .       . $$ $$ $$ $$      $$ $$      $$ $$     $$ $$  #
# .    $$$  .      . $$$ $ . $   $ $   $      $   $      $   $     $   $  #
# .   $   $ .      . $ $$$ .  $$$   $$$        $$$        $$$       $$$   #
#     $$ $$                                                               #
#     $   $  . $$$ $$$ .    ...     ....  .       .......                 #
#      $$$   . $ $$$ $ .   .   .   .    . . $$$ $ .      .       $    $$$ #
#    $       .         .  .     .  .    . . $ $$$ . $$$$ .      $  $    $ #
#  $  $       .   .   .  .       . .    . .       .    $ .     $  $   $$$ #
#   $  $      .   .   .  .  $$$  . .    . .       . $$$$ .    $  $  $ $   #
# $  $  $     .   .   .  . $   $ . .    . .  $$$  . $    .      $  $  $$$ #
#  $  $        . . . .   . $$ $$ . .....  . $   $ . $$$$ .  $$$   $       #
#   $   $$$    . . . .   . $   $ . ..     . $$ $$ .      . $   $ $   $$$  #
#    $ $   $   . . . .   .  $$$  . . .    . $   $ .      . $$ $$    $   $ #
#      $$ $$    .   .     .     .  .  .   .  $$$  .      . $   $    $$ $$ #
#      $   $    .   .      .   .   .   .  .       .      .  $$$     $   $ #
#       $$$     .   . $$$   ...    .    . ....... .......        $   $$$  #
#    $        *         $                                 $$    $  $      #
#  $  $     *  *      $$$.........   ....   .     .  ...  $    $  $    $$ #
#   $  $     *  *     $      .      .    .  .     . .   . $$  $  $  $   $ #
# $  $  $  *  *  *    $$$    . $$$ .      . .     . .   .       $  $   $$ #
#  $  $     *  *             .   $ .      . .     . .   .   $$$   $    $  #
#   $   $$$  *   ***   $$$   . $$$ .      . .     . ....   $   $ $     $$ #
#    $ $   $  * *   * $   $  . $   .      . .     . ..     $$ $$        $ #
#      $$ $$    ** ** $$ $$  . $$$ .      . .     . . .    $   $ $$$ $ $$ #
#      $   $    *   * $   $  .      .    .  .     . .  .    $$$  $ $$$ $  #
#       $$$      ***   $$$   .       ....    .....  .   .              $$ #
#                                                                       $ #
# $$$ $$$ $## ### ### ### ### ### ###+### ### ### ### ### ### ##$ $$$ $$$ #
# $ $$$ $$$ ### ### ### ### ### ### ### ### ### ### ### ### ### $$$ $$$ $ #
#                                                                       $ #
#     .     ....     ....     ....  $$$  .  .      .  .      $  $      $$ #
#    ..    .    .   .    .   .    . $ $ .  .  .   .  .  .   $  $  $    $  #
#   . .   .      . .      . .      .      .  .      .  .      $  $     $$ #
#     .   .      . .      . .      .  ...   .   ...   .   $$$   $       $ #
#     .   .      . .      . .      . .   . .   .   . .   $   $ $   $ $$$$ #
#     .   .      . .      . .      . .. ..     .. ..     $$ $$   $$$$$ $  #
#     .   .      . .      . .      . .   .     .   .     $   $   $     $$ #
#     .    .    .   .    .   .    .   ... $ $$$ ... $ $$$ $$$    $$     $ #
#   .....   ....     ....     ....        $$$ $     $$$ $           $  $$ #
#                                                                  $   $  #
# $$$$$$$   ... ...  $$$  .     ..... ..... ..... ....  .....     $  $ $$ #
# $     $  .   .   . $ $ ...    .       .   .     .   . .        $  $   $ #
# $$$ $$$ .    .    .   .. ..   .       .   .     .   . .          $   $$ #
# $     $ . $$ . $$ .   .   .   .       .   .     .   . .      $$$   $ $  #
#         .  $ . $  .  ..   ..  .....   .   ..... ....  ..... $   $ $  $$ #
#  $$$    . $$   $$ .  .     .      .   .   .     ..        . $$ $$     $ #
# $   $   . $     $ . .........     .   .   .     . .       . $   $    $$ #
# $$ $$   . $$$$ $$ . .       .     .   .   .     .  .      .  $$$     $  #
# $   $   .  $ $$$  . .       . .....   .   ..... .   . .....          $$ #
#  $$$      $$                                                          $ #
#                ....... ...... .    . .    . ....... .......          $$ #
# $$                .    .      ..   . ..   .    .    .                $  #
#  $    .     $$$   .    .      ..   . ..   .    .    .           .    $$ #
# $$   .  .  $   $  . $$ .      . .  . . .  .    .    .         .  .    $ #
# $   .  .   $$ $$  . $  ...... .  . . .  . .    .    .......    .  .  $$ #
# $$ .  .  . $   $  . $$ .      .  . . .  . .    .          .  .  .  .    #
#      .  .   $$$   .  $ .      .   .. .   ..    .          .   .  .      #
#  ...   .          . $$ .      .   .. .   ..    .          .    .   ...  #
# .   . .     $$    .    ...... .    . .    . ....... .......$$   . .   . #
# .. ..      $  $                                           $  $    .. .. #
# .   .    $ $  $ $  $ $$$ $$$ $$$ $$$ $$$ $$$ $$$ $$$ $  $ $  $ $  .   . #
#  ...      $ $$ $   $$$ $$$ $$$ $$$ $$$ $$$ $$$ $$$ $$$   $ $$ $    ...  #
#                                                                         #
 ######################################################################### 

; 0518_longevity_5
 ################### ####################### ##################### ######################### 
#@                  #                       #                     #                         #
# $$$$$$$$$$$$$$$$ $#$ $$$$$$$$$$$$$$$$$$$$$#$ $$$$$$$$$$$$$$$$$ $#$ $$ $ $ $ $ $ $ $ $ $ $ #
# $              $  #                       #  $               $  #   $ $ $ $ $ $ $ $ $ $ $ #
# $ $$$$$$$$$$$$ $ $#$$$$$$$$$$$$$$$$$$$$$ $#$ $ $$$$$$$$$$$$$ $ $#$ $$ $ $ $ $ $ $ $ $ $ $ #
# $ $          $ $  #                       #  $ $           $ $  #   $ $ $ $ $ $ $ $ $ $ $ #
# $ $ $$$$$$$$ $ $ $#$ $$$$$$$$$$$$$$$$$$$$$#$ $ $ $ $ $$$$$ $ $ $#$ $$ $ $ $ $ $ $ $ $ $ $ #
# $ $ $  $ $ $ $ $                             $ $ $$$$$ $ $ $ $      $ $ $ $ $ $ $ $ $ $ $ #
# $ $ $        $ $ $#$$$$$$$$$$$$$$$$$$$$$ $#$ $ $     $     $ $ $#$ $$ $ $ $ $ $ $ $ $ $   #
# $ $ $$$$$$$$$$ $  #                       #  $ $$$$$ $$$$$$$ $  #   $ $ $ $ $ $ $ $ $ $ $ #
# $ $            $ $#$ $$$$$$$$$$$$$$$$$$$$$#$ $     $         $ $#$ $$ $ $ $ $ $ $ $ $ $ $ #
# $ $$$$$$$$$$$$$$  #                       #  $$$$$ $$$$$$$$$$$  #   $ $ $ $ $ $ $ $ $ $ $ #
# $                $#$$$$$$$$$$$$$$$$$$$$$ $#$     $             $#$  $ $ $ $ $ $ $ $ $ $ $ #
# $ $ $ $ $ $ $ $ $ #                       #  $ $   $ $ $ $ $ $  #  $ $ $ $ $ $ $ $ $ $ $  #
 ###### ########$#.######################### ######.#####.###################### ########### 
# $ $ $ $ $ $  # #....#.......#.............#............#....#                             #
# $ $ $ $ $ $  # #....#... . .#...........  # . .  . ...#.....# $$ $ $ $ $ $ $ $ $ $ $ $ $$ #
#  $ $   $ $ $ # #....#... . .####.................. ..#......# $ $ $ $ $ $ $ $ $ $ $ $ $ $ #
#      $     $ # #....#####.##....####....  #  . . ...#.......#  $ $ $ $ $ $ $ $ $ $ $ $ $  #
#  $ $   $ $   # #....#...............##....#........#........# $ $ $ $ $ $ $ $ $ $ $ $ $ $ #
# $ $ $ $ $ $  # #.  .#  ...............#### ####.###.........#  $ $ $ $ $ $ $ $ $ $ $ $ $  #
# $ $ $ $ $ $  #  ..........................#... .  #.........# $ $ $ $ $ $ $ $ $ $ $ $ $ $ #
 ###### ##########.  .#  ...........#.......#. #..  #.........#  $ $ $ $ $ $ $ $ $ $ $ $ $  #
# $ $ $ $ $ $ $  #....#.....................#.. .#..#.........# $ $ $ $ $ $ $ $ $ $ $ $ $ $ #
#   $       $    #....##########..........###.#.....# ........#  $ $ $ $ $ $ $ $ $ $ $ $ $  #
# $$$ $$$ $$$ $$ #....#... .....##......##..#. .#...#  .......# $ $ $ $ $ $ $ $ $ $ $ $ $ $ #
#     $       $  #....#... .......##..##....#..........#......#  $ $ $ $ $ $ $ $ $ $ $ $ $  #
# $ $ $ $ $ $ $  #....#... .........##......#.......#  .......#   $ $ $ $ $ $ $ $ $ $ $ $   #
 ###### #############.#... .................#.......#.........#                             #
# $ $ $ $ $ $ $ $  # . . ...................##############.################################# 
#   $   $   $   $$ # . ..#..........#.......#............ . .#                               
# $   $   $   $    #..# ....................#............ . .#                               
# $ $ $ $ $ $ $ $  #...  . .................#.#..............#                               
 ###### ######################.##############....############                                
# $ $ $ $ $ $ $ $ $ $ $ $  #. .  ...........#....#........#                                  
#                        $ #. . .#..........#....#.......#                                   
# $$ $$ $$ $$ $$ $$ $$ $$  #..# ............#....#.......#                                   
#   $  $  $  $  $  $  $  $ #.... . #........#....# ......#                                   
# $$ $$ $$ $$ $$ $$ $$ $$  #.... ...........#....#  .....#                                   
#   $  $  $  $  $  $  $  $ #..... ... ......#.......#....#                                   
# $$ $$ $$ $$ $$ $$ $$ $$  #......# . ......#....#  ....#                                    
#   $  $  $  $  $  $  $  $ #........ ..#....#....#......#                                    
# $$ $$ $$ $$ $$ $$ $$ $$  #........#.......#....#......#                                    
#                          #................#....#......#                                    
 ########################## ################ #### ######                                     

; 0518_longevity_6
                                           ####               #########################  ##    ##    ##          
                            ##    ##  ##  #    #         ##  #  $ .  $  . $  .   $ .   ##  #  #  #  #  #         
                   ##  ##  #  #  #  ##  ## $$$  #   ##  #  ##  $  $ $.$ $    $ $   $ $ $ $  ##  $ ##  $ #        
                 ##  ##  ##  $ ## $  $$   $.$.$  ###  ## $    $.$..$...$.$ $$   $$..$.$  $  $  $ $  $    #       
                #   $  $ $  $ $ $ $$ $  $$.$.$.$  $ $   $ $  $..$$..$$$.$....$.$..$.$$.$..$$...$  $  $$ $ #      
                # $$  $$ $ $$ $ $ $   $ $....$..$ $ $ $  $  $.$.$..$....$.$$...$.$..$.$.$$..$.$.$ $ $   $  ##    
               #    $ $...$     $ $  $.$.$.$..$$...$.$$.$..$$..$.$$   $ .$..$..$.$.$..$.....$...$....$$$..$  ### 
            ###  $ $....$$.$$  $..$.$$.$...$$...$.........$.$$.$...$$  $...$..$.$.$....$.$$$.$$..$.$$..$.$.$$  .#
           #   $  $.$$......$.$.$.....$..$..$$...$.$..$.$$$...$..$$   $ $.$.$.$.$..$.$$$....$.$..$....$...$     #
         ##  $$$$$....$$$$.$.$$.$..$.$ $.$.$..$$.$.$.$..$..$$.$.$.$ $ $ $...$..$.$..$..$.$.$..$.$.$.$$.$.$.$$$ $#
        #  $    ...$.$....$.....$.$ $  $..$.$$..$.$.$.$.$.$...$..$.$.$.$.$.$..$.$...$...$$.$$    $.....$......$ #
      ##  $ $ $..$.$..$.$$ ..$$...$  $$....$......$..$...$.$.$..$.$.$..$$....$ $ $.$.$.$.$.$.$ $$$.$$$...$$$$$  #
     #   $   $.$..$..$.$   $.$.$.. $  $.$$....$$.$.$.$..$..$..$$..$.$.$$..$.$    $.$.$..$.$..$  $ $..$..$...$.$ #
     #   $ $$.$.$$..$...$ $..$.$$.$ $ $...$.$.$.$..$$.$$.$$..$..$..$.$..$...$ $ $...$.$.$$.$$$ $ $.....$.$$$.$  #
    #   $.$.....$...$.$$  $$$.$.$.$    $$$.$.$..$.$..$.....$..$..$.....$.$...$ $ $$.$.$$.....$    $$.$$.$.$.$.$ #
  ## $.$.....$.$..$$.$.........$...$$..$......$$.$.$.$.$...$.$ $$ $..$.$..$..   $..$..$..$$$$.$$ $$.$..$$..$..$ #
 #  $..$..$.$.$..$...$.$$$$.$$$.$$...$$.$$..$$........$.$$.$.$    $$$$$..$.$.$ $ $.$..$..$.....$$....$..$.$$.$  #
#  $.$$.$$$.$..$..$$.$.....$...$...$...$..$....$.$.$$..$.$$.$  $ $.....$...$$.$  $...$..$..$.$......$.$..$..$.$ #
#  $.......$.$$....$.$.$.$ $.$.$$$..$.$.$$.$$.$$$.$.$$.$...$.$$.$..$.$...$.....$$ $.$$...$$.$.$.$$.$$$.$..$$.$  #
 #  $$$.$.$.$....$..$.$.$   $.$.$.$.$$......$..$.$.....$.$$.$....$...$.$..$.$.$   $.....$$.$.$.$.$$..$.$.$.$.$  #
  #    $ $   $.$.$.$..$..$   $...$    $.$.$...$..$.$$.$.$....$$.$$..$...$$.$.$ $ $$$..$......$$..$.$$.$.$.$.$.$ #
   # $ $$  $$ ..$.$.$.$.$$$   $$..$  $.$$.$.$$...$..$.$..$$.$..$.$.$..$..$..$$  $   $.$$$$$$...$...$  $$  $$..$ #
   #  $$ $$    $...$...$...$$$..$..$$$.....$..$$$..$.$..$..$ $..$.$$$$$$..$$..$$.$$$.$......$.$.$.$$   $ $.$.$  #
    #      $ $ $ $..$$..$.....$$..$...$$.$..$......$  $$ .$$  $$ $.$..$..$..$$.....$$..$  $.$.$.$..$ $    ...$$$#
     ##  $ $  $  $$$...$.$$.$....$.$.$....$.$..$.$. $$ $ $.$ $   $..$.$.$ $  .$.$.$..$$ $$.$....$.$.$$..$$.$.. .#
       ##    $ $ $ $$$$.$  ...$.$...$..$$.$$.$.$$.$ $   $...$.$$.$...$.. $  $...$$.$$. $  $$$$$.$.$.$..$..$.$$  #
         # $$$ $    ....$$  $.$..$$..$..$...$.$.$..$  $$..$$..$...$$$..$$$$  $$.$..$..$ $ .....$.$..$.$.$.$.$.$ #
          #   $ $ $ $$..$  $ $.$$...$..$$.$  $ ..$..$  $....$..$..$..$  $   $...$..$.$    $.$..$.$$.$..$.$.$.$  #
          #      $ ..$.$$$   $...$$.$$$..$.$   .$$...$$.$$$..$$..$$.$. $ $ $ $$$..$.$$ $ $..$$$.$..$.$.$..$.$$  #
           # $  $ .$..$...$ $.$....$...$.$.$$ $...$$...$..$.$...$..$..$$$ $.$.$...$...$.$$.$..$...$...$..$$.$.$ #
           #  $ $ $.$.$.$.$....$..$.$..$..$   $$$.$.$$$...$.$$$$..$.$$ $  $.$....$.$.$..$..$ ..$.$.$.$$.$$.$.$  #
          #  $.$.$..$..$...$$.$.$.$..$$.$$.$$..$.$......$.$.....$$$...$..$$..$$$$.$...$$$$.$..$.$.$$...$..$..$  #
          # $.$.....$$..$.$..$.$.......$..$..$..$...$.$$$$.$.$...$.$.$ $..$.$$ $ $$$$   $ $ $$  $  $$$$ $$ $$ $ #
          # $..$$$.$..$.....$$..$.$.$$     $.$.$..$$$..$...$.$.$..$.$ $$   $             $                     @#
         #   $$...$$.$.$$$....$..$.$..$ $$ $....$$...$..$....$.$.$.    ######################################### 
         #  $..$....$.....$$...$$..$.$$$$ $ $.$$...$$ $...$..$$...$$ ##                                          
          #  $ $ $$...$..$  $   $ ..$...$  $...$..$ $  $$$$.$....$  #                                            
          #   $$   $...$$ $ $ $$  $.$.$$  $..$..$$   $    .$...$$ ##                                             
           #  $ $ $ $$..$  $ $  $$$..$  $ $..$$$. $ $ $ $ ....$  #                                               
            #  $ $ $..$...$..$...$.$.$......$.... $ $$ $$ $.$$ ##                                                
            #  $ $  $$..$$...$$..$....$.$$$$.$.$$ $ $ $    $  #                                                  
             #  $ $$....$..$..$$.$$.$..$...$..$.$$ $ $   $$ ##                                                   
             #   $..$.$$. $ $$$.$....$$ $$  $$.$  $     $  #                                                     
              # $$.$$$...$   ...$..$$     $ ... $ $ $ $$ ##                                                      
              #  ......$.$$$$..$..$..$ $$$ $.$.  $ $ $  #                                                        
              #  $.$.$$.$    $$.$$.$..$  $ $.$.$  $ $ ##                                                         
             #  $$$.$..$.$ $ $.$.$.$.$$   $ $.$  $$$ #                                                           
             #  $  ...$..$$$.......$...$ $  .$.$  $  #                                                           
         ## #  $ $ $.$$.......$.$.$$.$..$.$..$  $   #                                                            
        #  #    $ $ $..$..$$$$   $..$.$..$....$  $ #                                                             
        # $ ##   $$  $..$$    $ $  $ $$...$$$.$ $  #                                                             
        # $   ##   $  $$   $ $ $  $$ $  $..$.$.$  #                                                              
        #  $$   ##  $ $ $$   $ $ $     $ $....$$ #                                                               
         #   $$   #  $  $ $ $ $  $ $$ $  $..$$   #                                                               
          # $  $$  #  $ $  $   $$ $  $  $ $$  $ #                                                                
         #  $ $ $$  #  $$$$  #  $ $ $ $  $   $ #                                                                 
        #  $ $  $.$  #  $  #  #  . $   $ . #   #                                                                 
        #  $   $..$$  #   # #  ############  ##                                                                  
         #  $  $..$.$  ###  $    $  $  $    #                                                                    
          #  $$.$$...$ $   $   $   $ $    $$ #                                                                   
          # $......$$....$$.  $ $  $ $ $$$  $ #                                                                  
         #  $$$..$....$.....$..$ $        $  $ #                                                                 
        #  $  $.$$..$$.$$..$$.$... $ $ $ $ $ $ #                                                                 
        #  $ $ $..$.$..$.$$..$$.$.$  $ $   $  $ #                                                                
         #  $   $$.$....$.....$.$$.$  $.$ $    $ #                                                               
          ##  $$......$$...$$......$.$..$..$$$ $ #                                                               
            #   $$.$$.$...$..$$.$$$...$..$...$  $ #                                                              
             ##   $..$.$$.$.$......$$$.$$...$..  $ #                                                             
               ##  $.$..$..$..$.$$...$...$.$.$.$ $ #                                                             
                 #  $..$...$...$..$....$$.$$.$.$  $ #                                                            
                  #   $.$.$.$$..$.$$.$...$...$.$   $ #                                                           
                   #   $$$...$...$..$.$....$$...$    #                                                           
                   #  $...$.$..$$.$..$..$.$...$$ $  #                                                            
                    # $..$.$.$.$....$..$....$$ $ $ #                                                             
                   #  $.$....$..$$$.$...$$.$       #                                                             
                   # $ $.$..$....$....$$.$.$  $$$ #                                                              
                  #     .$$$...$..$.$....... $   #                                                               
                  #  $$$$...$$.$.....$..$$$$  $$ #                                                               
                   ##    .$...$.$.$.$.$..$  $   #                                                                
                     ## $..$.$..$.$.$.$.$.$  $$#                                                                 
                       # $..$.$.$.$.$.$..$ $   #                                                                 
                       # $ .$..$.$...$.$    $ #                                                                  
                        # $..$$.$.$.$.. $  $$#                                                                   
                        # $.....$.$$..$  $   #                                                                   
                         # $.$$..$...$.$   ##                                                                    
                         # $....$...$.$  ##                                                                      
                          # $.$.$..$ $ ##                                                                        
                           # $$...$$  #                                                                          
                           #  $$$$    #                                                                          
                            #      ###                                                                           
                             ######                                                                              

