; 1004_pathology_sokopath_1
##### ########
#   ###      #
#       ## # #
#  ###     # #
#     #  # # #
#  #    ##   #
####   #    ##
#   ## # ##  #
# # ## # #   #
# $        #.#
###### #$# #.#
#      # ###.#
# ###  $ @ ###
# ### #### #  
#          #  
############  

; 1004_pathology_sokopath_2
######  
#    ###
# #$.  #
# @$.$ #
###$. ##
  # . # 
  ##### 

; 1004_pathology_sokopath_3
 ###### 
 #@   ##
##* .  #
#    # #
# *$## #
###    #
  ######

