; 0115_tbox_04_1
 ####    
 #  #####
 #$ $   #
 # . *  #
## * * ##
# *$*$.# 
#@* . .# 
#####  # 
    #### 

; 0115_tbox_04_2
 ####    
 #@ #####
 #$$    #
 # *$*  #
##.$. *##
# .$*$.# 
# . . *# 
#####  # 
    #### 

; 0115_tbox_04_3
 ####    
 #  #####
 #   .*@#
 # .*$$ #
##$ $.*##
#  **  # 
#.. $  # 
#####  # 
    #### 

; 0115_tbox_04_4
 ####    
 #@ #####
 #$$ .  #
 # ***  #
## . . ##
#  .$*.# 
# $ $  # 
#####  # 
    #### 

; 0115_tbox_04_5
 ####    
 #  #####
 # .  . #
 # * $* #
##$.$.$##
#.$$$  # 
#  +  .# 
#####  # 
    #### 

; 0115_tbox_04_6
 ####    
 #  #####
 # $$   #
 #@* *. #
## $*  ##
#  ..$.# 
#   *$.# 
#####  # 
    #### 

; 0115_tbox_04_7
 ####    
 #  #####
 #  ... #
 # *$$$ #
## . .$##
# $*$$ # 
#@$ ...# 
#####  # 
    #### 

; 0115_tbox_04_8
 ####    
 #  #####
 #    $@#
 # *.*$ #
##$**.$##
#  ... # 
#     $# 
#####  # 
    #### 

; 0115_tbox_04_9
 ####    
 #  #####
 #  $.$ #
 # $*.  #
##  .. ##
#  $** # 
#   .*$# 
##### @# 
    #### 

; 0115_tbox_04_10
 ####    
 #  #####
 #   .  #
 # * $  #
##$.*.$##
#.$$$$.# 
#@*. . # 
#####  # 
    #### 

; 0115_tbox_04_11
 ####    
 #  #####
 # ..   #
 # $ $  #
##.* *$##
# ** . # 
#@$  .$# 
#####  # 
    #### 

; 0115_tbox_04_12
 ####    
 #  #####
 #  ..  #
 # * *$ #
##$.$.$##
# $*$. # 
#  @  .# 
#####  # 
    #### 

; 0115_tbox_04_13
 ####    
 #  #####
 #    $@#
 # *$*  #
##* . *##
# .$* *# 
#   .  # 
#####  # 
    #### 

; 0115_tbox_04_14
 ####    
 #@ #####
 #$$$   #
 # $.*..#
## $*..##
# . $* # 
#   .$ # 
#####  # 
    #### 

; 0115_tbox_04_15
 ####    
 #  #####
 #      #
 # $**. #
##$ *..##
# .. $ # 
# *.$$$# 
##### @# 
    #### 

; 0115_tbox_04_16
 ####    
 # .#####
 # .. $@#
 # $**$ #
##*  .*##
# ..$$ # 
# $    # 
#####  # 
    #### 

; 0115_tbox_04_17
 ####    
 #  #####
 #$  .  #
 #@$.$* #
##$ **.##
# .*$  # 
#   .  # 
#####  # 
    #### 

; 0115_tbox_04_18
 ####    
 #  #####
 #  $...#
 #.*$$  #
##   *.##
# .**$ # 
#    $$# 
##### @# 
    #### 

; 0115_tbox_04_19
 ####    
 #  #####
 # $.$  #
 # ..*  #
##$.*. ##
#  $*$ # 
#@$ .  # 
#####  # 
    #### 

; 0115_tbox_04_20
 ####    
 #  #####
 #  .   #
 # * $  #
##**$.$##
#  .** # 
# @$.  # 
#####  # 
    #### 

; 0115_tbox_04_21
 ####    
 #  #####
 #... $@#
 # $$** #
##*.   ##
# $$**.# 
#      # 
#####  # 
    #### 

; 0115_tbox_04_22
 ####    
 #  #####
 #.*  $@#
 #* .*$ #
##..$* ##
#  $.* # 
#   $  # 
#####  # 
    #### 

; 0115_tbox_04_23
 ####    
 #  #####
 #  $   #
 #*. *. #
##  *$ ##
# $.*@$# 
# ..$  # 
#####  # 
    #### 

; 0115_tbox_04_24
 ####    
 #  #####
 # .    #
 # * *  #
##$$$ $##
#  .** # 
# @*.. # 
#####  # 
    #### 

; 0115_tbox_04_25
 ####    
 #  #####
 #$ *   #
 #  .*..#
## $.$ ##
# .*.$ # 
#   *$$# 
##### @# 
    #### 

