; 0038_anomaly_2_1
#####  
#   ###
#  $@ #
#.**. #
# $  ##
##  ## 
 #  #  
 ####  

; 0038_anomaly_2_2
####      
#  # #####
#  ###   #
# $$+$$  #
# ..$.. ##
####  ### 
   #  #   
   ####   

; 0038_anomaly_2_3
 #####  
##   #  
#  . #  
# $.$###
##$.$  #
 # .@  #
 #######

; 0038_anomaly_2_4
  ##### 
### @ # 
#  $.$##
#  $*$ #
###.*. #
  # .  #
  #  ###
  ####  

; 0038_anomaly_2_5
  ##### 
  #   # 
###.*$##
#  .$  #
# #.$@ #
#  .$###
###  #  
  #  #  
  ####  

; 0038_anomaly_2_6
###### 
# $ .# 
#  *@# 
##. $# 
#  * ##
# $ . #
###   #
  #####

; 0038_anomaly_2_7
 ####   
 #  ####
 #  #  #
##$.$. #
# .$+$ #
# $.$. #
#    ###
######  

; 0038_anomaly_2_8
  #####
###   #
# $   #
# .* ##
# *.$# 
# .*@# 
# $ ## 
#  ##  
#  #   
####   

; 0038_anomaly_2_9
  ####  
  #  ## 
 ##   # 
## ..$##
#  $*$ #
#  $.. #
####@ ##
   #  # 
   #### 

; 0038_anomaly_2_10
  #####  
###@  #  
# ..$$#  
# #.$ ###
# $**.  #
##      #
 ###  ###
   ####  

; 0038_anomaly_2_11
####   
#  ####
#     #
#  #  #
##. . #
# $.$##
# .$. #
##$ $ #
 #@ ###
 ####  

; 0038_anomaly_2_12
 ####    
 #  #####
 #    $ #
 # # *  #
## .*. ##
#  *@# # 
# $#   # 
#  ##### 
####     

; 0038_anomaly_2_13
    #####
   ##   #
   #  # #
####    #
# @$$$$##
# .... # 
######## 

; 0038_anomaly_2_14
 ######   
##    #   
#    .####
# #$.*+$ #
#   *$*  #
###  #  ##
  ####  # 
     #### 

; 0038_anomaly_2_15
####   
#  ### 
#    ##
# .$* #
## *  #
# *$. #
#@  ###
#  ##  
####   

; 0038_anomaly_2_16
#######    
#     #    
# ### #    
# #@# #####
# $$$$$   #
# # # # # #
# .....   #
###  ######
  #  #     
  ####     

; 0038_anomaly_2_17
  ####  
### .#  
# $@.#  
#  $*## 
# #   ##
#  $*  #
# $ .  #
####.###
   ###  

; 0038_anomaly_2_18
####     
#  ###   
# $@ ####
# *.$.  #
# .$.*  #
###  $  #
  ####  #
     ####

; 0038_anomaly_2_19
######   
#    #   
#    #   
## # ####
 #$.$.  #
 #@$.   #
 #$.$.###
 #  ###  
 ####    

; 0038_anomaly_2_20
   ######  
  ##    #  
### $#* ###
# $*. .   #
#   . .*$ #
### *#$ ###
  #  @ ##  
  ######   

; 0038_anomaly_2_21
  ####### 
  #  #  # 
  #  #  # 
### * . # 
#  *$*$*##
#  @. *  #
#####    #
    ######

; 0038_anomaly_2_22
  ####   
  #  #   
  #  ####
  # $   #
###*.*  #
#  *+*###
#   $ #  
#  #  #  
####  #  
   ####  

; 0038_anomaly_2_23
 ####    
 #  ###  
## $  #  
# $ *.###
#@##..  #
# $ *.  #
## $  ###
 ###  #  
   ####  

; 0038_anomaly_2_24
   ##### 
 ###   # 
 # .   ##
 # .$$$ #
###.#.  #
# $$$.###
#  @#.#  
#######  

; 0038_anomaly_2_25
 ####     
 #  ####  
 #  #  #  
##.$#$.###
# .$@$.  #
# .$ $.  #
###  #  ##
  ####  # 
     #### 

; 0038_anomaly_2_26
    ##### 
 ####   # 
 #@$    # 
##$$##.###
# .. ..  #
# . #$$  #
###  $ ###
  ###  #  
    ####  

; 0038_anomaly_2_27
 ####    
 #  #    
##  #    
#   ###  
# *** #  
# *@* ###
# #*# $ #
#     . #
###   ###
  #  ##  
  ####   

; 0038_anomaly_2_28
 ####  
 #  #  
 #  #  
 #  ###
##$$  #
# .*  #
# @*###
##$*  #
 #..  #
 #  ###
 #  #  
 ####  

; 0038_anomaly_2_29
   #####
 ###   #
 #  $. #
## #.$##
#   $+# 
# ##.$# 
# # $.# 
#   .$# 
####  # 
   #  # 
   #### 

; 0038_anomaly_2_30
  #####   
  #   ### 
###$*.  # 
#   *   # 
#  @*#####
### *    #
 # .*$   #
 #   #####
 #####    

