; 0833_cocktail_1
#######   
#  #  #   
#    $####
# $#  #  #
## #$    #
#  #  #  #
#  #  # ##
#..#### ##
# .####$ #
#$   .   #
#.@####  #
####  ####

; 0833_cocktail_2
#########
#   ##  #
# *.... #
##$$ #  #
# $@## ##
#      # 
#### #$# 
   #   # 
   ##### 

; 0833_cocktail_3
   ####      
   #  ###### 
   #  $    # 
   #  #### # 
   ##$#### ##
#####  #... #
#     @ .*. #
# # $  #.#. #
# $ $$## $ ##
##### #### # 
    #      # 
    ######## 

; 0833_cocktail_4
   ####  
####  ###
#    $  #
# ##$ * #
# #@ $$ #
# #$  $ #
#.. # ###
#. .  #  
#. .#$#  
##.## #  
 #    #  
 ######  

; 0833_cocktail_5
 ########     
##  # . #     
#  $@   ####  
#  ##.  .  #  
## ####### #  
#    #  ## ###
#    # $     #
### ##  ##$# #
 ## ### ##   #
 #       #####
 #   #   #    
 #########    

; 0833_cocktail_6
    #####  
    #   ## 
#####@#  ##
# .$ .# $ #
#  #.*    #
#  #..# $ #
#    $# $ #
#  #  #  ##
########## 

; 0833_cocktail_7
   ########## 
   #    #   # 
   # #$$#$# # 
   #       @# 
   ###$ $#$ # 
  ####    $ # 
###  # ####$##
#    #   #.. #
#   .*.#$# ..#
# $ #*. ...###
### #   ####  
  # ###*#     
  #     #     
  #######     

; 0833_cocktail_8
  #########
  #...... #
 ##.*#### #
##   $  # #
# $    $# #
# #$##$   #
# $   $ ###
#  @#   #  
#########  

; 0833_cocktail_9
   ####  #####  
   #  ####   #  
   #         #  
   #  #####$### 
   #  #  #    # 
   #  #  #$## ##
#####.####  #  #
#...*. # $ $$  #
#..*.*.     #  #
## ###### # # ##
#  . $ $ @$ #$# 
#   ##   $    # 
##########  ### 
         ####   

; 0833_cocktail_10
     ##### 
  ####.  # 
  #  ... ##
  #  ...  #
  ###...  #
  ####.####
  #     #  
###$ #  ## 
# $   #  # 
#   $ # $##
##$ *##   #
 #  @   $ #
 # $$#$$ ##
 ##   $  # 
  ###   ## 
    #####  

; 0833_cocktail_11
    ####   ####    
  ###  #   #  #####
  #   $##### $  . #
  # +*.  # $...$  #
  ##   # # # $ ####
   #$###   ### #   
   #     #     #   
   ######### ###   
   #     #     #   
   # ###   ### #   
####$  # # #   ####
# $... . # $...$  #
#   $ $#####$ $   #
#####  #   # .#####
    ####   ####    

; 0833_cocktail_12
   ######### 
 ###    #  # 
##   $ $# $# 
#  $  # #  # 
# $$ ##  $ # 
#  #  #*#  # 
## #    ##.##
 # # #$.##..#
 # # # ..+..#
 # # #####. #
 # #  #  ####
 # $$ #      
 ###  #      
   ####      

; 0833_cocktail_13
 ######### 
 #  ##   # 
 # $$    # 
 #@ ### ###
###  ## $ #
# $  #    #
# $  $ #  #
#   $###.##
## $  #.. #
 #   $#.. #
 ##   #...#
  ##$.$..##
   #  #### 
   ####    

; 0833_cocktail_14
                 #########
               ###       #
             ###.# # # # #
        ######.# ..*.* # #
 ###   ##   ##$ * * * $. #
##.#  ##  #  # $ $ $ $ ###
# $# ##  * *   .$.$.$.$.# 
# .# #  * ############### 
# $# # * $#               
# .# #  * #  ##### #####  
# $####   #  #   # #  @#  
#  #.$ #  ####.# ###.#.#  
# ###.$ #   $  . * . # #  
# ##.$ $  ## #*# # # # #  
# ###.$ $ $ $.$  . $ ..#  
#  $ $ * $##.# ### ### #  
##                     #  
 #######################  

; 0833_cocktail_15
     ########
     #      #
     #$#### #
   ###  $ # #
  ##  .$# # #
  # .*.   # #
  #$##  ### #
  # .  #### #
  # # $$ $  #
  # . .*.  ##
###.#*#$# ###
# $@$ # *   #
# . .   ..$ #
### ## # $###
  #    #  #  
  #########  

