; 0526_sunday_warmup_1
  #############
 ## . *       #
##  #* * ##$$ #
#  #  * *# $@ #
# #  * * #    #
#   . * *# ####
## . # * . $ # 
 #####  ##   # 
     ######### 

; 0526_sunday_warmup_2
       #####       
      ##   ##      
      # . . #      
     ##.   .##     
    ##   #   ##    
   ### . . . ###   
  ## #  .@.  ####  
 ##  # . . . ##### 
##  $#  #$#  ######
## $ #### ####    #
# $  $       $  # #
#  $ #  #.#  #  $ #
#  $ ##$#.#$##$$ ##
# $  #  # #  #   ##
####            ###
###################

