; 0100_a.k.k._informatika_1
   ####
   #  #
   #  #
   #$.#
####  #
#     #
#@$.  #
#######

; 0100_a.k.k._informatika_2
########
#  #   #
#   $  #
#  #$$ #
## #   #
#.. $# #
#..   @#
########

; 0100_a.k.k._informatika_3
#######
#     #
# $ $ #
# $ $@#
# $$ ##
#  ...#
###...#
  #####

; 0100_a.k.k._informatika_4
 ########  
 # @#   #  
 # $  $ #  
 #$ #######
## $#     #
#. . .    #
#.  #######
#####      

; 0100_a.k.k._informatika_5
######### 
#   #@  # 
# # #  $##
#   $    #
## $ # # #
#...##   #
##########

; 0100_a.k.k._informatika_6
###########
#        @#
# #$ $ $  #
# # $$$$  #
# #$ $ $  #
# #     $ #
# #$### ###
# # #.....#
# # #.   .#
#    .....#
###########

; 0100_a.k.k._informatika_7
 ##############
 #            #
 #  $ $ $ $ $ #
 # # $ #####$ #
 # #$  #..#...#
 #   $ #..#.*.#
## #####..#..##
#         ##..#
# $ $ $@$  $$ #
###########   #
          #####

; 0100_a.k.k._informatika_8
 #####       
 #.  #       
 # $@#       
 #. ##       
### #########
# $ $ $ $   #
#      $    #
# ####### ###
#.   $   ..# 
######## ..# 
       ##### 

; 0100_a.k.k._informatika_9
   ########
   #      #
   #   $  #
#### #*#$ #
#... *+.$ #
#.*# #*#  #
#. # $    #
# $$    $ #
#  ########
####       

; 0100_a.k.k._informatika_10
 ###########
 #         #
 #  $ ####$#
## ####....#
#  $  #....#
#  $$ #..  #
## @$ ###  #
 # $$  $ $ #
 #      #  #
 ###########

; 0100_a.k.k._informatika_11
####         
#  ##########
# $$ $ #....#
#      #....#
#   $$# ....#
# $ @ #   ..#
# $##### ####
## #   #$  # 
#  # $$  $ # 
#    $ #$$ # 
#  #   #   # 
############ 

; 0100_a.k.k._informatika_12
########    
# . #  #####
# .$# $#   #
##. #   ...#
 # $# $#####
 #  #  #    
 # $# $#    
 #     #    
 #@ #  #    
 #  #  #    
 #######    

; 0100_a.k.k._informatika_13
#############
#           #
# $$ # # $$ #
#  $$...$$  #
#   ##.##   #
# .*.....*. #
#  ###.###  #
#### $.$ ####
   # $$$ #   
   #  @  #   
   #######   

; 0100_a.k.k._informatika_14
     ##########  
  ####    #   ###
  #  # $$ #     #
  #$ #   $#     #
###  #  $ #     #
#   $#$  $#*.####
#   $   $ #.....#
# $$$# $@$ .*...#
#    #    #.....#
#################

; 0100_a.k.k._informatika_15
######         ####
#    ########  #  #
# *** $ $ $ #  #  #
# .#.#$     #  #$ #
# +*.#      ####  #
# #$. $##$### $   #
# .*.   $         #
# ...########  ####
######      ####   

; 0100_a.k.k._informatika_16
#############  
#           #  
# $$ $ $ $  ###
#  $########  #
#   #.......$ #
# #$$......#  #
#@  # ## ### ##
### #  #      #
#    $ #   $  #
# #$#$ ###    #
#   #  # ######
########       

; 0100_a.k.k._informatika_17
########     
#@    .##    
#    #. #    
# $$ #. #    
#    #.$#    
###$##$ #####
# .     $   #
#..# $ $$   #
#..#### ### #
# .    $    #
#  ##########
####         

; 0100_a.k.k._informatika_18
####    #####
#  ######   #
# $$     $  #
#  ###### $ #
## #.*.* $  #
#  $....# $ #
#  #....#$@ #
# $###### $ #
#           #
#############

; 0100_a.k.k._informatika_19
        #######
####### #     #
#     # #     #
# $ $ # #    ##
# $$  ### ## # 
#  $$ #....# # 
# $#  #....# # 
#  # ###$### ##
# $ $ $... #$ #
#  #$ #...$   #
#  #@ ######  #
#######    ####

; 0100_a.k.k._informatika_20
  #########        
  #.......######## 
  #.......   #   ##
#######   #$ # $$ #
# $      $   #    #
# $##  # ### # $$##
#   $$ #...# #   # 
#    $ #...#$# $$# 
# $$$  #.*.  $   # 
#  $@$ ##$#$ #   # 
######      ###### 
     ########      

; 0100_a.k.k._informatika_21
   ####  #### 
####  ####  ##
# $    #  $  #
# .#.#.$ #   #
# $*..#  #$$##
#  ###... $  #
# $ $....#$  #
#  #$$#  #   #
#@    ########
#######       

; 0100_a.k.k._informatika_22
         #####    
##########   #    
#        #   #    
#  $ $ $ #   #    
# $ $ $ $#   #####
#  $ $ $ #   #...#
# $ $@$ $#   #...#
#  $ $ $ #... ...#
# $ $ $ $#...#...#
#  $ $ $  ...#   #
#        #...    #
##################

; 0100_a.k.k._informatika_23
     ############# 
######   ....#   ##
#    # $ *...# $  #
#  $ ## #....# $# #
#  $  # #...*# $ @#
# $$$ # #### #..###
#  #  #$ $ #  ..#  
# $#$ # $  .*## ## 
#  # $# # $** #  # 
# $#     $     $ # 
#     #  ######  # 
##########    #### 

; 0100_a.k.k._informatika_24
##########
#   #    #
#   #  $ #
# $.# $  #
# ..*.####
##$#.*.* #
#  $.#.$ #
# $  # $ #
#    #  @#
##########

; 0100_a.k.k._informatika_26
#############    
#  # ...$   #    
# $# ...$   #####
#  # $ $ $ $    #
# $## ###@# #   #
#   #...###$#####
# $ #...  #.  #  
#  $##$ #$#.# #  
#   $     $.  #  
#####  ########  
    ####         

; 0100_a.k.k._informatika_27
########### #####
#..     ..# #   #
#.$$$$$$$.###$$ #
# $..#..$  #    #
# $.$@$.$  # $$ #
# $..#..$  #  $ #
#.$$$$$$$.##$$  #
#..     ..#...###
##### ### #...#  
    #   $ $...#  
    ###########  

; 0100_a.k.k._informatika_28
#######           
#     ############
##$#  $ $  #.....#
#  #$ #     .....#
#  #     $ ####  #
#  #.##$# ##  ##$#
# $#.$ $   #     #
# $ .$ @####$$   #
####.$ $.... $ $ #
   ###  ##########
     ####         

; 0100_a.k.k._informatika_29
     ############  
     #          ## 
     #           # 
####### #######  # 
#@     $$ #   #..# 
#   $ $$  #$   ..# 
#  $ $$ $ #   #  # 
##$ $$ $  #$#### ##
#  $$ $   #...#.. #
#  $ $ $  #...... #
#       #  ...... #
###################

; 0100_a.k.k._informatika_30
              ####
###############  #
#  .*...#@$ $    #
#  #....#$$ $  $ #
#  #....#  $  $  #
#  #...*$ $$$ $$ #
# $#....#     $. #
#  #.*..# $ $  * #
#  .$ $ ####### ##
#  #    $ $ $ $ # 
########        # 
       ########## 

; 0100_a.k.k._informatika_31
  ##############
  #     #      #
  # $$   ***#  #
  #  $  #*.* $ #
  # #.# #...#  #
  # #*  # $ #$ #
  # #.#$#  $#  #
  #     #   #$ #
#####$$######  #
#   #..*..$ $$ #
# $  .....#   @#
################

; 0100_a.k.k._informatika_32
     ##############
     #  ....*@#   #
     #  #..*.$  $ #
     # $#...* #####
####### #....$#   #
#     # ####$   $ #
#  $ $# ...  ### ##
# $ $ # .*  $     #
#  $ $##.*#########
# $ $$   $  $  $  #
#       #         #
###################

