; 0247_keas_collection_1
 ########        
##      ###      
#  ##$#$ @#######
#        #   #  #
# $ $ ## #$  $$ #
# # #  #$# $#...#
#  ### $     ..##
#   # #$# $ #### 
# $ $ ..#.###    
#  $## .*..#     
#   #  ....#     
############     

; 0247_keas_collection_2
 #######                
 #     #                
 #$##  ##               
##   #  #####           
#  $  # $   ##          
# # #   #  # ##         
# $  $#   #   ##        
##  #  $#  $   ##       
 # # $  $ # $ $ ##      
 #    #$# # #$#  #####  
 ## $#  #$$$$..# #...###
  #     # #  .........+#
  ##  $#    #$#......###
   ##    $$  $ #.$#.##  
    ## # $ $$#  ....#   
     ####  #   ######   
        ## #####        
         ###            

; 0247_keas_collection_3
#########           #### 
#@#     ##  #########  # 
# # $$ $ #### $ $     .##
# ###  $  #     $ #$##. #
#   # ## $    ## ##  #.##
### #   $ ## ### ###... #
#   ##  #   $###  #..#.$#
# ### $ # $$ #  $ #.... #
#   #$ $ $  ##$ $ #.. #.#
# # $  $  ###   # #.....#
# #$  #  ## #  $$ #...###
# $   ####  ###   #...#  
# #  ##       #########  
######                   

; 0247_keas_collection_4
##########################
#           #       ##   #
##.#.#.#.*. $   $ $ ## $ #
# ......### ########## # #
# ......# $ $ $   $    $ #
## ######    $  #   ######
#  #.*....**$ # # #     # 
#  #....*...# $ $ $  $  # 
#  #$###############$#### 
#  $   $  $   $      #    
#  ##@$# #$ # #$# # ##    
#  ## $   $ # $     #     
#  ##$# # ### ###$###     
#####             #       
    ###############       

; 0247_keas_collection_6
##############
#  #  #  ##@ #
#   $ #   ## #
# $#  $ $  $ #
##   #  #### #
#    # ##    #
# #$##    ####
#   $  #  #   
##$  #....#   
#  #$$...##   
#  $ #...#    
#  #  .###    
########      

; 0247_keas_collection_7
####################
#  #    #  #   #   #
#...  $ $  #$#  $# #
#  ##$##      $    #
##$#   #$####### $ #
#. ###           # #
#. .#   # ##$$## # #
#...# ###      $   #
##..# $   #$########
 ##.#####   #       
 #..   ####$##      
 # .         #      
 ###     ## @#      
   # # #  ####      
   #       #        
   #########        

; 0247_keas_collection_8
   ####         
   #  #####     
 ###      #     
##  ..#   #     
#   ... ########
#  #.#..#  #   #
#   . .#    $  #
###### # $#$#$##
     #     $  # 
     # #  $#  # 
     # $$# $  # 
     ###   $ ## 
       #   # @# 
       ######## 

; 0247_keas_collection_9
###########
#.  $.    #
#.#$##$##.#
#   $.   .#
#.$  #$ $.#
#.##$$  #.#
#. $ . $$ #
#.$$#$# #.#
#@ $ .   .#
###########

; 0247_keas_collection_10
         ####      
##########  ###### 
#    #           # 
# $    $ $#$#$$  # 
# $######  $  ## ##
#  #   .##    $   #
# $# #... # #   $ #
#  # #... #  # ####
# $#  ....## $  #  
#  ###....#  #$ #  
##$#   #.## $ $ #  
# $    #.      ##  
#@#     .#######   
##########         

; 0247_keas_collection_11
###############    
#@#   #       #####
#     #$ #### $ $ #
##..# # $   $ #   #
 #..     #### # # #
 #..# ######    $ #
 #.. $        #$# #
 #..# # # # #   $ #
 #..  ###$#$###$# #
 #..####  $    $  #
 # ####   # #   ###
 #      #########  
 ########          

; 0247_keas_collection_12
    ##############           
 ####    #       ####        
 #   $## # ##$ #  $ #####    
##$    #    $  #$#  #   #    
#  ## ## # ## #     $ # #    
#  ##  $   ##   ###     #####
# $## #################$##  #
#...........................#
# ###################### #  #
# $      $  $            #  #
###### #### $  # ##$### $   #
#@ ###       # # #    ## ####
## ##  # $  ##   ####       #
 # #  $ ###$ ##$ #  ## $ #$ #
## $   ## #     ##   ###  $ #
#  #$# #  # #$  ##    # $# ##
##     #  #    ##     #    # 
 ##   ##  ##  ##      ##  ## 
  #####    ####        ####  

; 0247_keas_collection_13
#####        
#   #####    
# $$#   ###  
#    $    ## 
##$ $ $ $  # 
#   #####$ # 
#  $#     ###
#   # #####@#
##$##.....# #
#   #..#..# #
# $ #..#.*$ #
#   $.....# #
######$##$# #
    #  $ $  #
    ##      #
     ########

; 0247_keas_collection_14
######### 
#      @# 
# ##$##$# 
# $   # # 
# # $   ##
# $ ###  #
# # . # ##
####*##  #
#.... $  #
##  . #  #
 #########

; 0247_keas_collection_15
#################
#  .. #    ##   #
#  .#$  #$    # #
#...# $#  $#$#  #
## ##$ $ #     ##
##  $  #  $ ## ##
# $ # ###$#$#...#
# # #       #.  #
#   #@##### ..  #
#######   #######

; 0247_keas_collection_16
#########################
#...#          #     # @#
#...#$ ####### $ ##$    #
#...   # $    $# $   #  #
#...#$## # $ #   # #$#$##
#  #  #    #  $$ #   #  #
#  #  $  $  $ #  #$$##  #
## # #############   #  #
## # ..#         $ # # ##
## # ..##$##### ##$$ #$##
#  # ..          $ #    #
#...  ####$## #      #$##
#...##   # ## ########  #
#...        #  $ $ $ $$ #
#...#  #   ##           #
#########################

; 0247_keas_collection_17
#######################
#..#        #         #
#.. ## ## #$#  #$ $$$ #
#..     #   ## $  # $ #
## ###$ ##$$# $#      #
#  #  $  $  #   #######
## #   # #..*.#  #    #
#  ##### $  # $  $ $$ #
# .#   ### $# $#$# #..#
# .#     ## #      #*##
# .# # $@#  # ######..#
# .    # #.... $  # ..#
#   #    #  # $   $ ..#
#######################

; 0247_keas_collection_20
###############
#     #+###   #
# $#$$$.$  $# #
#  $  #.#$ $  #
#  $  #.#  #$ #
## $  #.#     #
## ####.#######
#......*...*..#
# $####.#### ##
#  $ ##.#  $$##
# $ $ #.#  $  #
#  #$ #.$ $#  #
##    #.      #
###############

; 0247_keas_collection_21
         ##########  
         #@       #  
         ###$#$#$$###
         #          #
         #  #   #$  #
         ##$# # $ # #
         #  ##  # $ #
         # # $ #   ##
   #######     $ #$ #
   #   ##  ## ## $  #
   # #  ....#  $ #  #
   #    ...##$#$  $##
   # #  ...##   #   #
#### # ##...# # $   #
#      #....#   #  ##
#   #  ##############
########             

; 0247_keas_collection_22
  #######  
 ##     #  
##  #$  #  
#  #   $###
# $ $#$ $ #
##.... $  #
 #*#.*$## #
##..#. #@ #
# .*.* ####
#   # $#   
# $##  #   
#      #   
########   

; 0247_keas_collection_23
  #########      
###       ##     
#   # #$#  #     
# $##   # $####  
#   # $ $  $  ## 
# $ ## ###$##  # 
# #    #      $##
###$# ### ####  #
##. # $      #  #
#...$ # ###   $ #
#...###$###  ####
#.....#   $ ##@ #
#......   ## ## #
##$#$#$#######  #
 #             ##
 ############### 

; 0247_keas_collection_24
############## 
#  #     #   # 
#    $ #$ $  # 
#  # # $  #### 
##$#$   #    ##
#    ### $ $  #
# # $  $ ## # #
#   ## #  #   #
#####.*.. #####
  ###...###@#  
  #  ..##   #  
  # #. #    #  
  #  .#   ###  
  #     #  #   
  ## #     #   
   #      ##   
   ########    

; 0247_keas_collection_25
 #############          
 ##     #.  .####       
 #      ........###     
 # # # ####..##.  ###   
 #     .....####  # ##  
 #   # .#####  # ##  #  
 ######..  #  $#   $ ## 
 ##   # .#  #  $ # #  # 
 #  # ## ##$   # $    # 
##     #     ###  # # ##
# #$$ ## #$### ## $ $$ #
#   #    #   $ $  #    #
#  # $#    $ # #$ # ####
##    ### ##$#     #   #
 ##    $  ## # # # $  ##
  ######  $   $$     ## 
       ## #  #@#######  
        #########       

; 0247_keas_collection_26
      ############### 
     ##     #       ##
    ##  #$#  $ # # #+#
   ##  $  $  #    . .#
   #  #  #  # # # .#.#
#### #  $ #$ $ #. . .#
#   $  # #   #. . . .#
#   #$  $ $#  # # .  #
##$#  # #   # . . # ##
 #       $# $$. #  ## 
 ###  ##  $ # . $ ##  
   #######    # ###   
         ###  ###     
           ####       

