; 0349_microban_04_variations_1
#####  ####  
#   #  #  #  
# $ ####$ ## 
#  $.... $ ##
##  ####  @ #
 #  #  #    #
 ####  #  ###
       ####  

; 0349_microban_04_variations_2
    ####   
    #  #   
  ###$.##  
###     #  
# . **  ###
# $ *@* $ #
### *** . #
  #     ###
  ##.$###  
   #  #    
   ####    

; 0349_microban_04_variations_3
    ####   
    #  #   
  ###$.##  
###   * #  
# .* *  ###
# $ *@* $ #
###    *. #
  # *   ###
  ##.$###  
   #  #    
   ####    

; 0349_microban_04_variations_4
#######   
#  #  ### 
#.$#  * ##
#  @ * * #
#  ##    #
#####  ###
    ####  

; 0349_microban_04_variations_5
#######   
#  #  ### 
#.$#    ##
#  @ * * #
#  ## *  #
#####   ##
    ##### 

; 0349_microban_04_variations_6
  ####    
  #  #####
 ##      #
 # .**$  #
## #  # ##
#  ***. # 
# $    ## 
##### @#  
    ####  

; 0349_microban_04_variations_7
 ####### 
 #  .  # 
 #  $# # 
###$$+.##
 #  $# # 
 #  .  # 
 ####### 

; 0349_microban_04_variations_8
     ##### 
 #####   # 
 #  # $# ##
## **  $  #
# .*.+# $ #
#  ** #   #
##   ######
 #   #     
 #####     

; 0349_microban_04_variations_9
 ####### 
#   .   #
# #$#$# #
# $. .$ #
#.# $ #.#
# $...$ #
# #$#$# #
#   +   #
 ####### 

; 0349_microban_04_variations_10
 ####### 
##     ##
# $.$.$ #
# .$.$. #
# $.*.$ #
# .$.$. #
# $.$.$ #
##  @  ##
 ####### 

; 0349_microban_04_variations_11
     ####               
     #  #### #####      
     #     # #   ###### 
     # $$  # #        # 
   ####  $## ##....  .# 
   #    $ ##  ##  #. .# 
#### ##$#  #   #  #. ## 
#  $$##@## ######### ###
# #    $               #
#   ### ### ########   #
##### #     #      #####
      #######           

; 0349_microban_04_variations_12
         ####
##########  #
#   $   ... #
#  $ $   #  #
#### #### . #
  # $  @  ###
  #   #####  
  #####      

; 0349_microban_04_variations_13
########   
#   #  ####
# # @     #
# # * $$# #
#  #*##   #
##  *.  ###
 ##.* ###  
  #  ##    
  #  #     
  ####     

; 0349_microban_04_variations_14
    ########  
#####  @   #  
#   #$$#$# ## 
# #         # 
# ###*##### # 
#  # .... # # 
## # .... # ##
#  #####$##  #
# $  $    $$ #
###   #   #  #
  ############

; 0349_microban_04_variations_15
 ####      
 #  #######
##.$#  *  #
#     * * #
# @ #  *  #
######* ###
     #   # 
     #   # 
     ##### 

; 0349_microban_04_variations_16
#########       
###    ##  #### 
#    * ##  #  # 
# ****  ####$.##
#  *@*      $..#
#  **** ####   #
## * $  #  #####
##    ###       
#########       

; 0349_microban_04_variations_17
 ####        
 #  ###      
 # $* #######
 #  . $ #   #
###.# . $ # #
#   .*#*. $ #
# # $ . #@###
#   # $ .  # 
####### *$ # 
      ###  # 
        #### 

; 0349_microban_04_variations_18
    ####  
#####  #  
# $.$ *#  
#  . . ###
###*. $$ #
 # .#.   #
##$. $.###
# $ #$ #  
# @    #  
########  

; 0349_microban_04_variations_19
 #####   
 #   #   
 # # ####
 # $.*  #
 # .$ * #
###*#$.@#
#  .$ * #
# #$.*  #
#    ####
#   ##   
#####    

; 0349_microban_04_variations_20
  ####  
  #  #  
  # $#  
###  #  
# $ $###
# ..$  #
##.@*  #
 #.. ###
 #.$$###
 #. $  #
 ###   #
   #####

; 0349_microban_04_variations_21
#######      
#   @ #      
# $ $ #####  
####$...  #  
   # .# * ###
   #$...$#  #
   # .#.$ $ #
   #$.$$.   #
   #  #  ####
   ####$ #   
      #  #   
      ####   

; 0349_microban_04_variations_22
  ####### 
  #  #  # 
  # $$$ # 
  #.....# 
####$.$## 
#   $. ###
# $  .   #
####$.$  #
   # @####
   ####   

; 0349_microban_04_variations_23
   ####    ##### 
   #  #    #   # 
   # $#    #$# ##
   #  ######    #
   ## . $ .  $# #
#####$.#.#. #   #
#   # .#.#.$#####
# $ @ .$. . #    
####  $.$.$ ##   
  #  ######  #   
  # $#    #$ #   
  #  #    #  #   
  ####    ####   

; 0349_microban_04_variations_24
       #       
 ############# 
 ## *     .  # 
 # .$.$$$.$. # 
##.$*$.*.$*$.##
 # .$.$$$.$. # 
 #@ .     *  # 
 ############# 
       #       

; 0349_microban_04_variations_25
      # #      
 ############# 
 ##   .$.   ## 
##.$  $.$  $.##
 #$.*** ***.$# 
##.$  $.$  $.##
 ##@  .$.   ## 
 ############# 
      # #      

; 0349_microban_04_variations_26
      ###      
 ############# 
 ## $.   .$  # 
##  *$.$. *  ##
## .$.$*$.$. ##
##  * .$.$*  ##
 ##@$.   .$ ## 
 ############# 
      ###      

; 0349_microban_04_variations_27
     # # #     
 ############# 
 #         . # 
 # .**$  **$ # 
###*  ***  *###
 # $**  $**. # 
 #@.         # 
 ############# 
     # # #     

; 0349_microban_04_variations_28
     # # #     
 ############# 
 # $       . # 
 # .**   **$ # 
## *  ###  * ##
 # $** # **. # 
 #@.       $ # 
 ############# 
     # # #     

; 0349_microban_04_variations_29
     ## ##     
 ############# 
##   .   .   ##
## $$*$$$*$$ ##
 #.....#.....# 
## $$*$$$*$$ ##
##@  .   .   ##
 ############# 
     ## ##     

; 0349_microban_04_variations_30
   ### # ###   
 ############# 
 ###   .     # 
## .$ $$$.$. ##
##*$.*...*.$*##
## .$.$$$ $. ##
 #@    *   ### 
 ############# 
   ### # ###   

; 0349_microban_04_variations_31
  ### #### ###  
 ############## 
##    #       ##
 #$.$  .$.$.$.# 
##.$.$.$.$.$.$##
##$.$.$.$.$.$.##
 #.$.$.$.  $.$# 
##@      #    ##
 ############## 
  ### #### ###  

; 0349_microban_04_variations_32
  ## # ## # ##  
 ############## 
##    .  $    ##
##**.**$$**.**##
 #  $ ...$ $  # 
 #  $ $... $  # 
##**.**$$**.**##
##@   $  .    ##
 ############## 
  ## # ## # ##  

