; 0424_arrangements_1
############     
#          #     
# $        #     
### $$#### ######
#  $   ### #    #
# $ ## ##.    # #
# $ ##...  ##   #
#  $@#.*.#### # #
###  #...   # $ #
  ######$## # # #
       #    # ###
       #       # 
       ##  #   # 
        ######## 

; 0424_arrangements_2
  ##########     
  #    #   #     
 ##   $    ######
## $$$#### ##   #
# $    ##     # #
# $ ##...  ##   #
#  $@#.#.#### # #
###  #...   # $ #
  ###### ## # ###
       #       # 
       #   #   # 
       ######### 

; 0424_arrangements_3
  ##########     
  #    #   #     
 ##   $    ######
## $$$#### ##   #
# $    ##.    # #
# $ # .... ##   #
#  $@#.# #### # #
### $#..    #   #
  ## #.# ## # ###
  #  $ #       # 
  #    #   #   # 
  ############## 

; 0424_arrangements_4
     #######     
  ####...  #     
  #  ....# ###   
  #$ ##..#   #   
  #  ### # # ####
  #$$# #     ...#
  #  ### ####.$ #
###$ ##  ##### ##
# $ $   ##@ ## # 
# $ $ $ ##$ ## # 
# # # # ## $## # 
#       $      # 
#############  # 
            #### 

; 0424_arrangements_5
   ######      
####  #+##     
#   $ #..##### 
# $#$ .*.*.  ##
#  #  #.** #  #
# $#$$##.* $  #
#  #    #.    #
# $#$ #   #####
#     #####    
####  #        
   ####        

; 0424_arrangements_6
             ####  
##############  ## 
#   $   $      $ # 
# $   $   #### # # 
## ###########.# # 
#  #   #      .*.# 
# $  $ #$$ # #*#.# 
#  ## ##   #  .*.# 
####  ##$# ###.#.# 
   # $  $  #...#.# 
   #  ##  @##.## # 
   ##########.## ##
          #   $ $ #
          #       #
          #########

; 0424_arrangements_7
             ####  
##############  ## 
#   $   $      $ # 
# $   $   #### # # 
## ########### # # 
#  #   #      .*.# 
# $  $ #$$ # #*#.# 
#  ## ##   #  .*.# 
####  ##$# ###.#.# 
   # $  $  #...#.# 
   #  ##  @##.##.# 
   ##########.##.##
          # $ $ $ #
          #       #
          #########

; 0424_arrangements_8
             ####
      ########  #
  #####         #
  #   $$# ##### #
###   #   #   # #
#.# # #$#$#####.#
#.* $ # + $   ..#
#.. $ $ * ## $..#
#.##### #$ ## #.#
# #   # $  ## ###
# #   #    ## #  
# ###########$#  
#             #  
###############  

; 0424_arrangements_9
 #####         
 #   ##########
 # # $ $ $... #
 # # $    .#. #
 #.. # ###..*##
 #.....$  #  # 
 ##$### $ # $# 
 #    #$  #  # 
 #$ #  @$ # $# 
 # ##$#####  # 
 #    ###   $# 
##$## ###$...# 
#  # $    .#.# 
#  $ $ $ $.*.# 
#    ######  # 
######    #### 

; 0424_arrangements_10
 #####         
 #   ##########
 # #$$   $... #
 # # $    .#. #
 #...#$###..*##
 #.....$  #  # 
 ##$### $ # $# 
 #    #$  #  # 
 #$ #  @$ # $# 
 # ## #####  # 
 #    ###  $$# 
##$##$###$...# 
#  #      .#.# 
#  $ $ $ $.*.# 
#    ######  # 
######    #### 

; 0424_arrangements_14
        ####       
#########  ####    
#        $ #@ #    
#  #..#### #$ #    
# $#..    $   #    
##  ..#### ########
 #$# #   #$ ####  #
 #     #    #     #
 ### ######$$ $ $ #
   # #  # # $# # ##
   #$ $ ###  #   # 
   # #       #$ $# 
   # #.#####.# $ # 
   #... #  #.## ## 
   #... #  #.. $ # 
   ######  ###   # 
             ##### 

; 0424_arrangements_15
            ##### 
     ########   ##
    ##.*.        #
    #....$#####  #
 ####..#   $  $$##
 #   $## ### #  # 
 #$   ##   #  $ # 
 # $ $## # $$@# # 
 #$ $  # $ #  # # 
 # $ $ # # #$## # 
 #$ $  # #      # 
 #  ## # ######$# 
##*..# # ### ...##
# .#. .$. .  .#. #
# ...$ $ $ $ *.. #
##############  ##
             #### 

; 0424_arrangements_16
            ##### 
     ########   ##
    ##.*.        #
    #....$#####  #
 ####..#   $  $$##
 #   $## ### #  # 
 #$   ##   #  $ # 
 # $ $## # $$@# # 
 #$ $  # $ #  # # 
 # $ $ # # #$## # 
 #$ $  # #      # 
 #  ## # ######$# 
##*.## # ###....##
# .#.. $ $  ..#. #
# ...* $ $ $.*.. #
##############  ##
             #### 

; 0424_arrangements_17
  #####  #######
  #   ####     #
  # $$    $ $$ #
  #   #### # # #
  ### #  # $ $ #
    # #  # $   #
    # #####$####
 #### #......## 
 # $  #..**...# 
 #  $ #.....*.# 
 ## $$ #####.###
  #    #### *$ #
### #####   $  #
# $ ##### $ # ##
#  $          # 
#@  ########### 
#####           

; 0424_arrangements_19
     ############  
     # ..       #  
     # ..###### #  
     ## ## ##.# #  
      # # ##..# #  
      # ###..*#$###
    ### ##..*.*   #
    #    ..*.# #  #
#####   $.*.# $  ##
#@  #### *.# $ $ ##
#    # # .# $ $ $ #
##$$$### ##  $ $  #
 #   ## $ ##$ $ $ #
 #        # $  $  #
 ###  #   #     ###
   ##############  

; 0424_arrangements_20
         ########
 ####    #      #
 #  ######$$$ $ #
 #  $...  $    ##
 #  #...  ##  $ #
### ##+##### $  #
#   $...$  #$ $ #
# #$#..* $ # $# #
# # ##$### #  $ #
# #..# ##..  #  #
# #..*  *..## $ #
#  ..## #..# $  #
## #### ## #  # #
 #          $$$ #
 #  #####  #$ $ #
 ####   ####    #
           ######

; 0424_arrangements_59
  ############     
  #  #  ##   #     
  #     @    #     
 ## ### ### #####  
 #...## ###...  #  
 ##...# ##...##$###
  ##...  ..#*$ $  #
####$###$#...  #  #
#    ##  #### ##$ #
# $# ## ##  #     #
##      ########$ #
 # ###      $  $  #
 # #  ## #  #  $ ##
 # $ $   $ # $$ $ #
 #  $ $ #$##      #
 ###      #########
   ########        

