; 0651_fibolandia_9
 ##### 
 # .@# 
 #$.$# 
 # * # 
 # * # 
 # * # 
 # * # 
 # * # 
## * # 
#  * ##
#  *  #
##    #
 ##  ##
  #### 

; 0651_fibolandia_10
 ##### 
 # .@# 
 #$.$# 
 # * # 
 # * # 
 # * # 
 # * # 
 # * # 
 # * # 
## * # 
#  * ##
#  *  #
##    #
 ##  ##
  #### 

; 0651_fibolandia_45
 ##### 
 # . # 
 #$* # 
 #@* # 
 # * # 
 # * # 
 # * # 
 # * # 
 # * # 
 # * # 
## * # 
#  * ##
#     #
##  * #
 ##  ##
  #### 

