; 0698_sokobet_1
####################
########  #   #   ##
##        #     # ##
##  $ ### ## #.    #
###$#$    ## . .   #
#  $ $ #     .#.   #
#@$   $#####.###.###
# $$$$$    #.....###
# $   $ ##  .## . ##
#   ##  #######   ##
####################

; 0698_sokobet_2
###############
##       ######
## # # # ######
## #$$$$  #####
##  $   $ #####
## #$   $ #####
##  $$$$  ##  #
## #$   $###  #
##  $   $ ## @#
## #$$$$     ##
##   # ### #  #
####   ###    #
########## # ##
####.... # # ##
##  .   .# # ##
#   .  #.    ##
#   .... # ####
#   .#  .  ####
##  .   .# ####
####....   ####
###############

; 0698_sokobet_3
##########
#   #  ###
# # #   ##
#   **#  #
# #*  *  #
#  .##$#@#
# #*  *  #
# # **   #
#  #  #  #
##   #####
##########

; 0698_sokobet_4
############
####     ###
#### ### ###
#### ...  ##
##  #.##. ##
## $$* #. ##
#  $ .$#.  #
# #$ .*.   #
#  $  $#####
#  $$$ #####
### # ######
### @ ######
############

; 0698_sokobet_5
###############
######  #######
#       #     #
# # ....#$$$$ #
# # .##     $ #
# # ...## $$$ #
# # .####   $ #
#   .... $$$$ #
##  ######   @#
###############

; 0698_sokobet_6
##################
###   #  #########
# $$$    #... #  #
# @ $ #   .#     #
###$$  ###..  #  #
### $  ###.####  #
### $ ##  .      #
###      ##   #  #
##################

; 0698_sokobet_7
###############
#             #
# $########$$ #
#     ...## # #
# $ #.#  .$ # #
# # *$#$##. $ #
# #.  #   $.# #
# #.# #  $#.# #
# #.#$### # # #
# #*   .*..*# #
# #. # $###.  #
# ##*# $  .$$ #
# #  . ##.$#  #
#@$  #.*.  $  #
####$# #$ #$###
####        ###
###############

; 0698_sokobet_8
#############
#   ####  ###
#     #     #
##.##*$$$$  #
##.##. $@####
# .... $  ###
# .##*$$$$###
# .  .#    ##
#  ##      ##
#  ##########
#############

; 0698_sokobet_10
#########
#####   #
##### . #
##### * #
###   * #
##  # * #
##  # *##
##$ # * #
# *@# * #
#  ***  #
##  #  ##
##    ###
#########

; 0698_sokobet_11
##########
#  ###  ##
# *  *  ##
# .$.$#  #
##.+$$   #
# .$.$#  #
# *  *  ##
#  #######
##########

; 0698_sokobet_13
##########
##      ##
## .#  .##
###** **##
#  * * * #
#  * # * #
#  *   * #
## $## $@#
##     ###
##########

; 0698_sokobet_15
####################
###########  #######
########  #  #   ###
########  #      ###
########  ##   #####
######### .....#####
####  #   .## .#####
####  # ##.###.#####
##    # ##.###.#   #
#  # #  ##.###.    #
# $$$$$ ##. # .  ###
# $   $ # .....   ##
# $ # $##   ####  ##
# $ # $      ### @##
# $ # $####  #######
# $   $ ###  #######
# $$$$$ ############
#       ############
####################

; 0698_sokobet_16
##########
#        #
# ...### #
##.# .## #
##.#$*$  #
##..*  $ #
##.#$  $ #
##. $$$###
##.#$    #
##  $ ## #
## @$    #
#####  ###
##########

; 0698_sokobet_18
###############
########  #####
##   ###  #####
## $      #####
#  $ ####$   ##
# $$#### $$$ ##
# # .... # $ ##
#  #.###.#   ##
## #.  #.### ##
## #....  ## ##
## #*#.## ## ##
## #.  .   # ##
## #.# @.  # ##
## $$####### ##
## $   $  $   #
## $ $    #   #
## $ ##########
##   ##########
###############

; 0698_sokobet_20
#########
##  ##  #
#.....  #
# #. #  #
# #. #  #
# #.   ##
#  . ####
####$####
#   $   #
# # $#  #
# # $   #
# $$$$$##
#   @  ##
#########

; 0698_sokobet_23
###############
#   ######    #
# $ $     $ $ #
#  $ $ $ $ $  #
# $ $ $ $ $ $ #
#  $ $ $ $ $  #
# $ $ $ $ $ $@#
## ####### ## #
# .   . .   . #
# . ##. .###.##
###.## .#  . ##
## .## .  #. ##
##  .#. . . ###
#  #.#.#.#. ###
#    .   . ####
###  .#  . ####
###############

; 0698_sokobet_24
##############
##    ########
## $#      ###
##  #.###.   #
##$$#. # . # #
##  # . .# # #
#  $ # .   # #
# $#  .#.#   #
#   #.   . ###
#  $ .###.  ##
#  $   $  # ##
## $$#$$$#  ##
##   #@    ###
##############

; 0698_sokobet_26
##############
#    #########
# $$ $  $  $ #
# @$$## # ## #
##$#         #
## # #  ### ##
## # # ...#  #
## # ### .   #
## # ###.## ##
## #   ...   #
## ### ####  #
## ###  ###  #
#       ######
#   ##  ######
##############

; 0698_sokobet_27
################################
#####################  #########
###############        ##    ###
###############  ##### ##    ###
################ #   # ### #  ##
####   ####  ### #   ..... #  ##
###  $   ##  ### ## .#.###    ##
### $#$    $$$   ##.# .#   #  ##
##  $ $  # $  ## ##.# ...#    ##
## $   $###$$    ##....### #  ##
#  $$$$$ # $  ## ##.##. ##     #
#  $   $   $$$   ##. #....   # #
##   #   #   ######     ##     #
################### @###########
################################

; 0698_sokobet_28
##########
##      ##
# $ #  . #
#  ****  #
# * $.#* #
# * $. * #
# * .$ * #
# *#.$ * #
#  ****  #
# .  # $ #
##   @   #
##########

; 0698_sokobet_29
#########
#   .   #
# ## ## #
#   *   #
## * * ##
#  *#*  #
# * @ * #
# ***** #
# * # * #
# # $ # #
#       #
###   ###
#########

