; 0888_00xian_1
 ############
 # .  $ . $@#
 #$#.#$. .$$#
 # * .$*# . #
 # *$ * $ #.#
##  # $.$## #
# ..#.$ .# $#
#$$ . .$ .  #
#.*$ * .$$. #
#  #$ .#.$$.#
# . *$ .  $ #
#    * ######
########     

; 0888_00xian_2
#############
#          @#
# #*#*#*#*# #
# *   $   * #
# # #.#.# # #
# * . $ . * #
# #$#$ $#$# #
# * . $ . * #
# # #.#.# # #
# *   $   * #
# #*#*#*#*# #
#           #
#############

; 0888_00xian_3
 ###########
 #    #....#
## $$ @ $$ #
#   $.# $. #
# ###*####.#
# .  .#    #
## *#..$$ ##
 # * .#$   #
 # $###  $ #
 #.   $  * #
 #######$# #
       #   #
       #####

; 0888_00xian_4
###########
#@      * #
# $ $ $ # #
# $$$$#$#.#
# # # #.$ #
# ..... . #
##.#.##.#$#
# $# $ $# #
#$ .$#....#
#  $ .  $ #
# *.##$##$#
# *  * ## #
#.#*## ## #
#         #
###########

; 0888_00xian_10
 #####      
 #   #######
 #    $    #
###*###### #
#  @ $   # #
# *$$ $  # #
#$.#   ### #
#.*..#$  # #
#....  $ # #
##*####### #
## $     # #
# . *.*. # #
#    $ $ # #
#### ##### #
   #       #
   #########

; 0888_00xian_11
###### 
# . .# 
# $.$##
# $.$ #
# $.$ #
#.$.$.#
# * * #
#.$@$.#
# * * #
#.$.$.#
# $.$ #
# $.$ #
##$.$ #
 #. . #
 ######

; 0888_00xian_12
############
#   #      #
# $$$$$*#$ #
# #   #... #
#   # ...# #
# $ $  #.# #
#$####*#.  #
# #  * .$###
#  $ #*#   #
#.#  *@* # #
# ##.*** . #
# #   # $# #
#     #    #
############

; 0888_00xian_14
    #######    
   ##...# ##   
  # ... $  ##  
 #.***$#$   ## 
 #...  # #$$ # 
#...#$#  #    #
# *.  # #     #
 #.#$#  #$#$$# 
 #.  # # $   # 
 ## #  #     # 
  # # # $$$$#  
  #   # $   #  
   # # @   #   
    #######    

; 0888_00xian_15
########       
#      ########
# ## #$    #  #
# #    ##$$$  #
# #  $ #  $   #
# # #$$$@$  # #
# # # .# $ ## #
# #$##... ### #
#  ...*.##### #
###. #..#     #
  #.###$# #####
  #..#  $ #    
  #*.$    #    
  #  ######    
  ####         

; 0888_00xian_16
     ###### 
     #    # 
 ##### $  # 
 #   #$ $ # 
 #$     # ##
## ####$$$.#
# $    $ $ #
#...###  #$#
###.*....$@#
 ##...###$##
 #..*.     #
 # .$$#$   #
 ####    ###
    ######  

; 0888_00xian_20
##############
#         * @#
# # #.###$*  #
# # # $   $$##
# # # ***.*.# 
# # .   $ $ # 
# ###*###.*.# 
# ###       # 
# #######$#.# 
#           # 
############# 

; 0888_00xian_30
############
# .        #
#  **###*# #
## *     * #
 # *$*+*$# #
 # *     * #
 # **##### #
 #         #
 ###########

; 0888_00xian_41
###############
#.   * @ *   .#
#  #       #  #
# $##*#*#*##$ #
#  #   $   #  #
# ## # . # ## #
#.$.$ # # $.$.#
#     # #     #
#######*#######
#    .$ $    .#
#$$## #.$$#.  #
# .$. #  . $#$#
#..$.*$*$.$.  #
#*   $  . ## .#
###############

; 0888_00xian_57
    #####    
   ## @ ##   
  ##  #  ##  
 ##  * *  ## 
##  * * *  ##
#  *.*.*.*  #
# # $ $ $ # #
# #### #### #
#           #
#############

; 0888_00xian_60
      ##### 
     ##   ##
    ##  *  #
   ##  **# #
  ##  ** . #
 ##  #$ .$ #
##  *$ .** #
#  ** .#$  #
# ** .*$@ ##
#  #.$*  ## 
##      ##  
 ########   

; 0888_00xian_62
############ 
#          ##
# ########+ #
# #   *   * #
# #   *   * #
# ###*$###* #
# #   *   * #
# #   *   * #
# ########* #
# #   *   * #
# #   *   * #
# ####$*#####
# *   *   #  
##.   *   #  
 ##########  

; 0888_00xian_65
###############
#@ . $  .$    #
# $$ $# #$.#$.#
# ..$. . . .$ #
#$$$.$#.#.$.$$#
# ...$  $$# . #
#.$$ #.##...$ #
# $. $. $ $$# #
# ##.#.##.....#
# $. $. #$$$$ #
# #$##$ #.#.$ #
# .$ $. #  .. #
# ## ##.$$#$# #
#     $ . #   #
###############

; 0888_00xian_82
#############
#   #       #
# # $ #$#.# #
# $.$.$.$.$ #
##$.$.#.. ###
# .$.$$ .$. #
# #.$ # $.# #
# .$. $$.$. #
### ..#.$.$##
# $.$.$.$.$ #
# #.#$# $ # #
#       #  @#
#############

; 0888_00xian_83
######  #### 
#@   ####  # 
# ## . .$$ # 
# ##$$.*$..##
# $... .$$. #
# $#$$$.$ # #
# ... ##$.. #
##$$#.$.$$.##
# ... ..... #
# #$$#$#$$# #
#  $ # $ $  #
##     #   ##
 ########### 

; 0888_00xian_89
      ###### 
     ##   @# 
    ##  $# ##
   ##  **.  #
  ##  **    #
 ##  **  $# #
 #  **  **. #
 # **  **   #
##**  ** .# #
# *  **  *$ #
#   **  **  #
## **  **  ##
 #**  **  ## 
 #   **  ##  
 ###  ####   
   ####      

; 0888_00xian_93
    #######      
  ###     ###    
###   *.*   ###  
#   ** $ ##   ###
# #* ###*# *#   #
# . *  *  *  *$@#
# #* ###** *#   #
#   ## $ *#   ###
###   *.*   ###  
  ###     ###    
    #######      

