; 0893_ac_2021_22_5
      #### 
#######  ##
#         #
#  *****  #
## *   * ##
 # * # * # 
 # * # * # 
 # * # * # 
 # * # * # 
 # * # * # 
 # * # * # 
 # * # . # 
 # * ######
 # $    $ #
 # .*****+#
 #      $ #
 #  #######
 ####      

; 0893_ac_2021_22_8
###########
######   ##
###### $ ##
###    $ ##
###  # #  #
#@$$$$  $ #
#    #    #
## ########
#. ########
#$$#  #  ##
#  ...** ##
# # # #. ##
#   ....###
###########

; 0893_ac_2021_22_16
##########         
#   # #@ ######    
# #   #$  #   #    
# #$ ...*.#$  #    
#   #.#$ #.  ##    
# $ #.#  #.$ #     
# $ #.####.# #     
# # $*.*...# #     
# $ $   #  $ #     
# #####$#$## #     
#            #     
## ####$# ######## 
 #    # #        ##
## # #  # ######  #
#   ## ## #     # #
# #.* $ # #.* $ # #
# #     # # ## #  #
#  ###### #  #   ##
##      #  #  #### 
 #### # ## ## #    
    # #.* $ # #    
    # #     # #    
    #  #####  #    
    ##       ##    
     #########     

; 0893_ac_2021_22_21
####################
#       $ $....#   #
# #$$#$$# #...**$  #
# $  $  $ ####.# # #
# $  $ @$ #....#   #
# $  $  $ #  #.#   #
# #$$#$$# #$$###   #
#       $ $...*.#  #
### # ### #.***.$  #
#   $     #.*...#  #
# #$$#$#$ $.**.*#  #
#         #.....# .#
####################

; 0893_ac_2021_22_25
        #        
       ###       
      ##@##      
     ##   ##     
    ##  *  ##    
   ##  ***  ##   
  ##  *   *  ##  
 ##  ***$***  ## 
##  *   .   *  ##
#  *** *** ***  #
# *   *   *   * #
#  # ### ### #  #
## ### ### ### ##
 #             # 
 ############### 

; 0893_ac_2021_22_26
          #          
         ###         
        ##@##        
       ##   ##       
      ##  *  ##      
     ##  ***  ##     
    ##  *   *  ##    
   ##  ***$***  ##   
  ##  *   .   *  ##  
 ##  *** *** ***  ## 
##  *   *   *   *  ##
#  *** *** *** ***  #
# *   *   *   *   * #
#  # ### # # ### #  #
## ### ### ### ### ##
 #                 # 
 ################### 

; 0893_ac_2021_22_28
       ####  
   #####@ #  
####      #  
#  ***.***## 
#  *  $  * # 
## *  #  * # 
 # .$# #$. # 
 # *  #  * ##
 # *  $  *  #
 ##***.***  #
  #      ####
  #  #####   
  ####       

