; 0940_kevin_collection_1
######     
#    ######
# $.$.$.$ #
# $.$.$.$ #
# $.*+*.$ #
# $.$.$.$ #
# $.$.$.$ #
###. . .  #
  #########

; 0940_kevin_collection_2
             # 
            ## 
           ### 
          #   #
   ######## # #
  # $ $ $ $   #
 ##.$.$.$.$*$# 
###..........@#
 ##.$.$.$.$*$# 
  # $ $ $ $   #
   #######  # #
          #   #
           ### 
            ## 
             # 

; 0940_kevin_collection_3
#####      
#   #######
# $.$.$.$ #
# $.$.$.$ #
# $.*+*.$ #
# $.$.$.$ #
# $.$.$.$ #
## . . .  #
 ##########

; 0940_kevin_collection_4
##############
#            #
# $********* #
# *        * #
# * ###### * #
# * #    # * #
# * #    # * #
# * #    # * #
# * #    # * #
# * ###### * #
# *        * #
# *********+ #
#           ##
##############

; 0940_kevin_collection_5
     #####     
  ####   ###   
  #    *   ### 
 ## *$.$**   # 
 #  . #. $.* # 
## *$. $#. $ ##
#  * #$.$ #.  #
# *$.$.@.$.$* #
#  .# $.$# *  #
## $ .#$ .$* ##
 # *.$ .# .  # 
 #   **$.$* ## 
 ###   *    #  
   ###   ####  
     #####     

; 0940_kevin_collection_6
#####           #####
#   #############   #
#  $  $ $ $ $ $  $  #
#**.**.*.*.*.*.**.**#
#         @         #
#**.**.*.*.*.*.**.**#
#  $  $ $ $ $ $  $  #
#   #############   #
#####           #####

; 0940_kevin_collection_7
####     #####
#. ##   ##  .#
# $ ## ##  $ #
#  $ ###  $ ##
##  $ #  $ ## 
 ##  .*.. ##  
  ## .  *##   
   ##*  . ##  
  ## ..*.  ## 
 ## $  # $  ##
## $  ### $  #
# $  ## ## $ #
#+  ##   ## .#
#####     ####

; 0940_kevin_collection_8
       ######## 
   #####  #   # 
  ##  $  $$ $ # 
 ##  $.#  #.### 
##  $.# # ...## 
#  $ #   #.**.##
# # $ $#  ..*..#
#  #. $ # #.$*.#
##  # #.. ##..##
 ## $  #$ ##### 
 ##  $$ $    #  
 # $$  # #   #  
 #@   $  #####  
 ####  ###      
    ####        

; 0940_kevin_collection_12
  #####           
  #   ##          
  # $* ###########
  # #  *         #
  # # *  ######$ #
  # # # *      * #
  # # # * ###*  ##
  # # #$..$   *## 
  # #  .##.**  #  
  #  **.##.  # #  
 ##*   $+.$# # #  
##  *### * # # #  
# *      * # # #  
# $######  * # #  
#         *  # #  
########### *$ #  
          ##   #  
           #####  

; 0940_kevin_collection_16
  ####     
  #  #     
  #  #     
  #$.###   
  #    #   
###.**$#   
#      #   
#$***#.### 
#        ##
#.#*****$ #
#   @     #
###########

; 0940_kevin_collection_19
   #####   
  ##   ##  
 ##  #  ## 
##  *$*  ##
#  * * *  #
# #  *  # #
# #. # .# #
# # *$* # #
# # *@* # #
# # *$* # #
# #. # .# #
# #  *  # #
#  * * *  #
##  *$*  ##
 ##  #  ## 
  ##   ##  
   #####   

; 0940_kevin_collection_20
   #######   
  ##     ##  
  #  ***  #  
  # *$@$* #  
  #  ***  #  
  ## * * ##  
  ## * * ##  
 ##  * *  ## 
##  ** **  ##
#  * # # *  #
# *  #    * #
# .$** ##$. #
# *.  *  .* #
# .$###**$. #
#  * $ $ *  #
##  *.*.*  ##
 ##       ## 
  #########  

; 0940_kevin_collection_23
 #####       
 #   ########
 # $        #
 ##$### ##  #
 #  ## * # ##
 # $...... # 
## ### . # # 
#     $###$# 
#   #    $@# 
#####$# #### 
    #   #    
    #####    

; 0940_kevin_collection_24
    ######    
    #    #    
 ####$ $$#####
 #   $   #   #
 # $   $   $ #
 #   ##$######
####$##  $ $ #
#   $ #  $@  #
# $ $ #.######
##  $ #.#...# 
 # ##...$...# 
 #   ....*..# 
 ############ 

; 0940_kevin_collection_25
    ######    
    #    #    
 ####  $$#####
 #   #   #   #
 # $   $   $ #
 #   ## ######
####$##$ $ $ #
#   $ #   @  #
# $ $ # ##..##
##  $ # #...# 
 # ##   ....# 
 #    ##....# 
 ############ 

; 0940_kevin_collection_31
    #######   
#####  .  #   
#     * * ### 
# ## ** $   # 
#  $* *$*#* # 
##  *  *    ##
 # # .$** #  #
 # * #.$ *#* #
 # # ##  *   #
## *  * *# ###
#  $* * *   # 
# ## ##*# * # 
#  .  #  .  # 
### ***** ### 
 # **   #* #  
 # # #   * #  
 # #.***** #  
 #    @    #  
 ###########  

; 0940_kevin_collection_32
      ######       
    ###    ##      
   ##  .*.*@###    
  ## $*$ $$*$ #### 
  #  .  ##  .    ##
 ##$*.. ### #.##  #
## $  *$# $ $ ### #
#  .$.$  . *.**.  #
# *#. $$.*.$   $ ##
# .$*..*#   ###### 
# *$  $$ #$##      
#  **..... #       
##  $ $  #.#       
 ###### ** #       
      #$*  #       
      #   ##       
      #####        

; 0940_kevin_collection_34
      ########### 
  #####    #    ##
###  $ .$$.# **  #
# $..$.*  * *  * #
# +*$* * #. ## * #
# $. * *  *### * #
#. # * .$$.# $*  #
# $#  #    #    ##
# .############## 
# $ #             
#   #             
#####             

; 0940_kevin_collection_37
#############  
#@   #      #  
#.$*$#  * * #  
# $. * *#* *#  
# * *  *  * #  
## # * * *  #  
#  # ***  * ## 
# *#    ***  # 
#  ###**   * ##
# *  * *$*# . #
#  * . *  #*$ #
# * *#$##.$.$.#
#    *    .   #
###############

; 0940_kevin_collection_47
####     ####
#  #######  #
# $   .   $ #
# .*******. #
# *       * #
# * ***** * #
# * # $ # * #
# * # + # * #
# * # $ # * #
# * ***** * #
# *       * #
# *######## #
#           #
#############

