; 0943_ac_2024_25_1
####       #####
#. ##     ##  .#
# $ ##   ##  $ #
#  $ ## ##  $ ##
##  * ###  * ## 
 ##  $ #  $ ##  
  ##  .*.. ##   
   ## .  *##    
    ##*  . ##   
   ## ..*.  ##  
  ## $  # $  ## 
 ## *  ### *  ##
## $  ## ## $  #
# $  ##   ## $ #
#+  ##     ## .#
#####       ####

; 0943_ac_2024_25_7
 ####          
 #  ###########
 #$ . $ $ $ $ #
 # .#. . . .  #
 #$ ######## ##
 # .#. #. #. # 
 #$ # $#  $ $# 
 # .#  *  #. # 
 #$@$  # $# $# 
 # .# .# .#. # 
## ######## $# 
#  . . . .#. # 
# $ $ $ $ $ $# 
###########  # 
          #### 

; 0943_ac_2024_25_8
 ############### 
##      #      ##
#  ## # # ####  #
# ##   * *   ## #
# #   ** **   # #
# ####  +  #### #
# #   ** **   # #
# ##   *$*   ## #
#  #### # # ##  #
##      #      ##
 ############### 

; 0943_ac_2024_25_9
 ############### 
##      #      ##
#  ## # # ####  #
# ##   * *   ## #
# #   ** **   # #
# ####  +  #### #
# #   ** **   # #
# ##   *$*   ## #
#  #### # ####  #
##      #      ##
 ############### 

; 0943_ac_2024_25_30
           #####           
           #   #           
          #  *  #          
         #  *$*  #         
        #  # . #  #        
       #  #  *  #  #       
      #  #  *$*  #  #      
     #  #  # . #  #  #     
    #  #  #  *  #  #  #    
   #  #  #  *$*  #  #  #   
  #  #  #  # . #  #  #  #  
##  #  #  #  #  #  #  #  ##
#  *  *  *  ###  *  *  *  #
# *$.*$.*$.## ##.$*.$*.$* #
#  *  *  *  ###  *  *  *  #
##  #  #  #  #  #  #  #  ##
  #  #  #  # * #  #  #  #  
   #  #  #  *$*  #  #  #   
    #  #  #  .  #  #  #    
     #  #  # * #  #  #     
      #  #  *$*  #  #      
       #  #  .  #  #       
        #  # * #  #        
         #  *$*  #         
          #  +  #          
          #######          

; 0943_ac_2024_25_60
   #######   
  ##     ##  
 ##  *    ## 
## **#**** ##
#  *     *  #
#  * *** #. #
#  * *@* *  #
# *# *** *  #
#  *     *  #
## ****#** ##
 ##    $  ## 
  ##     ##  
   #######   

; 0943_ac_2024_25_64
###################
#.               .#
#.*****$$$$$*****.#
#.#             #*#
##*######@######*##
#*#             #.#
#.*****$$$$$*****.#
#.               .#
###################

