; 0980_kevin_collection_2_5
#############
#.    +    .#
# # $$.$$ # #
#  ## . ##  #
# $##$.$##$ #
#$$ $...$ $$#
#.....#.....#
# $ $...$ $ #
# $##$.$##$ #
#  ## . ##  #
# # $$.$$ # #
#.   $.$   .#
#############

; 0980_kevin_collection_2_19
############
#@.$.$.$.$ #
# $$. . .. #
#..$$ $$$$ #
# $$.....$$#
#....$.$.$.#
#$ $$$.$$$ #
#..$.$.$.$.#
# ...$...  #
#$$ $$.$$$.#
# . .$ $.  #
############

; 0980_kevin_collection_2_42
    ####     
#####  ######
#           #
# #****#### #
# #       # #
# # #***# # #
# # #   # # #
# # *.* # # #
# # $ $@* # #
# #.*.#*# # #
# $ $     * #
###.####### #
  #         #
  ###########

; 0980_kevin_collection_2_46
###############
#@            #
# $####*##### #
# * . #     $ #
# #.$.# #*### #
# $ .$. #   $ #
# # #.$.# #*# #
# $ # . . # $ #
# #*# #.$.# # #
# $   # .$. $ #
# ###*# #.$.# #
# $     # . * #
# #####*####$ #
#             #
###############

; 0980_kevin_collection_2_48
###############
#.           .#
# $*$## ## #$ #
# # * # # * * #
#  *.  #  .*$ #
# #  # # #  # #
# ##  .$.  ## #
#   ##$ $##   #
# ##  .$.  ## #
# #  # # #  # #
# $*.  #  .*  #
# * * # # * # #
# $# ## ##$*$ #
#.     @     .#
###############

; 0980_kevin_collection_2_49
 ########### 
##         ##
#  ###$#**  #
# *$ . . $# #
# * .*$*. # #
# #$ .#. $# #
# # .*$*. * #
# #$ . . $* #
#  **#$###  #
##    @    ##
 ########### 

; 0980_kevin_collection_2_50
   ####### 
 ###    @# 
 #   ###$# 
## #*# # # 
#  # ### ##
#      *  #
# * * * * #
# * * # * #
# ***##*# #
# * * # # #
# * * # # #
# * * # # #
# . # # # #
###       #
  #########

; 0980_kevin_collection_2_52
#############
#           #
# ##*****## #
#  $ *   *  #
# #.* #** # #
# .$$. .$*. #
# ##. $  $# #
#    *$*..# #
## ### *  # #
 # ###@*#$# #
 #   #**  # #
 #$ *   *   #
 # ..###*. ##
 #$* ##  *$# 
 # . ##.$. # 
 #$# #   #$# 
 #     #   # 
 ########### 

; 0980_kevin_collection_2_61
   #### ####
   #  ###  #
  ##..$ $  #
  # **#.#  #
### ....*$##
#   #*  #@# 
# $  $ $ $# 
##   ##   # 
 ########## 

