; 1014_cjcjc-2x2-10x10_1
#######
#@    #
# #*# #
# $ . #
# #*# #
#     #
#######

; 1014_cjcjc-2x2-10x10_2
#########
#@      #
# #$#*# #
# * . $ #
# #.#*# #
# $   . #
# #*#*# #
#       #
#########

; 1014_cjcjc-2x2-10x10_3
###########
#@        #
# #.#$#*# #
# $ * .   #
# #*# #*# #
# . * $ * #
# # #.#.# #
# * $ * . #
# #$#*#$# #
#         #
###########

; 1014_cjcjc-2x2-10x10_4
#############
#@          #
# # #*# #.# #
# * * . * $ #
# #*#$# #*# #
#     *   * #
# #*#*#*#*# #
# *       * #
# # #*#*#*# #
# * * $   . #
# # #.#*#$# #
#           #
#############

; 1014_cjcjc-2x2-10x10_5
###############
#@            #
# #.#$#.#*#$# #
# * $   . $ . #
# #$#$#.#$#.# #
# * . * * $ * #
# #.#*#$#.#.# #
# .   . $   $ #
# #$#*#*#*#$# #
# $     $ . . #
# #.#.#$#*#$# #
# * $ . . $ * #
# #$#.#*#*#.# #
#             #
###############

; 1014_cjcjc-2x2-10x10_6
#################
#@              #
# #$#.#$#.#*#.# #
# . $ . $ . $ * #
# #*#$#.#.#$#$# #
# * $ * $ . . * #
# #.#.#$#.#*#$# #
# .     * . $ $ #
# #.#$#.#$#*#.# #
# $ * . $ $ . . #
# #*#$# # #*#$# #
# . * $ * .   $ #
# #$#.#$#$#.#*# #
#   . $ . . $ $ #
# #*#*#.#$#*#.# #
#               #
#################

; 1014_cjcjc-2x2-10x10_7
#######
#@. $ #
# #*# #
# $ . #
# #*# #
#     #
#######

; 1014_cjcjc-2x2-10x10_8
#########
#@    * #
#.# #.# #
# * *   #
# # #*# #
# $ * . #
#$#*#$# #
#       #
#########

; 1014_cjcjc-2x2-10x10_9
###########
#@        #
#.#*#$# #*#
# * * *   #
# # # #*#$#
# . $   * #
#$# #.#.#.#
#   * * * #
#*# # #$# #
#         #
###########

; 1014_cjcjc-2x2-10x10_10
#############
#@  * * . $ #
#$# # # #$#.#
# * $ .   * #
#.# #*# #.# #
#     * $ . #
#.#*# # #$#$#
# . $ * *   #
#$#*# # # #*#
#       *   #
# #*# # #.# #
# . $ * . $ #
#############

; 1014_cjcjc-2x2-10x10_13
#########
#@      #
# ##$## #
# #  ## #
# .  *  #
# ##*## #
# ## ## #
#       #
#########

; 1014_cjcjc-2x2-10x10_14
############
#@         #
# ##$##*## #
# ##  # ## #
# *  *  $  #
# ##.# .## #
# ## ## ## #
# $  *  .  #
# ##.##$## #
# ## ## ## #
#          #
############

; 1014_cjcjc-2x2-10x10_15
###############
#@            #
# ##$##.##*## #
# ## ## ## ## #
# *     .  $  #
# ##*## ##*## #
# ## ## #  ## #
# $  *  *     #
# # .##$##* # #
# #* ## ## ## #
# $  .  $  .  #
# ##.##* #*## #
# ## ## ## ## #
#             #
###############

; 1014_cjcjc-2x2-10x10_16
##################
#@               #
# ## ##*##.##*## #
# ## ## ## ## ## #
# *  *  .  $     #
# ##*##$ #*##$## #
# ## ## *# ## ## #
# *  *     .  .  #
# ## # $##.##*## #
# ## ## ## ##  # #
# .  $     $  .  #
# ##$##*##$ **## #
# ## ##  # ## ## #
# *  *     .  $  #
# ##.##*## ##*## #
# ## ## ## ## ## #
#                #
##################

; 1014_cjcjc-2x2-10x10_17
#####################
#@                  #
# ##*##*##*##$##*## #
# #  ## ## #  #  ## #
#    $     .  $  .  #
# ##*##$ #*##  #*## #
# #  ## ## ## ## ## #
# .  *     .     *  #
# ##$##$#####*## ## #
# #  ## ## ##  # ## #
# $  .  #        .  #
# ##.##*##. #*# *## #
# ## #  ## ## ## ## #
# $  *  $  $        #
# ##.##.##*##$##.## #
# #  #  ## ##  # ## #
# *  $  *  $  *  *  #
# ##. # # .##.##$## #
# ## ## ## ## ## ## #
#                   #
#####################

; 1014_cjcjc-2x2-10x10_20
############
#@         #
# ##.##*## #
# #  #  ## #
# *  $  .  #
# ##$ #* # #
# #  #  ## #
# $  *  *  #
# ##. #  # #
# ## ## ## #
#          #
############

; 1014_cjcjc-2x2-10x10_21
###############
#@            #
# ##.##$##.## #
# #  #  #  ## #
# $  *  .  $  #
# ##$ #* #$ # #
# #  #  #  ## #
# *  *  $  *  #
# ##. #. #  # #
# #  #  #  ## #
# *  $  $  .  #
# ##. #. #* # #
# ## ## ## ## #
#             #
###############

; 1014_cjcjc-2x2-10x10_22
##################
#@               #
# ##$##$##*##.## #
# #  #  #  #  ## #
# *  *        *  #
# ##  #* #* #* # #
# #  #  #  #  ## #
# *     .  $     #
# ##. #  #. #. # #
# #  #  #  #  ## #
# *  $  $     *  #
# ##* #* #* #$ # #
# #  #  #  #  ## #
# *     *     .  #
# ##. #$ #* #* # #
# ## ## ## ## ## #
#                #
##################

; 1014_cjcjc-2x2-10x10_23
#####################
#@                  #
# ##*##.##$##$## ## #
# #  #  #  #  #  ## #
# *  *  *  .  *  *  #
# ##  #$ #  #. #* # #
# #  #  #  #  #  ## #
# *     .  *  $  *  #
# ##$ #* #$ #  #. # #
# #  #  #  #  #  ## #
# *  $        *     #
# ##  #* #. #. #. # #
# #  #  #  #  #  ## #
# *  *  $  $     *  #
# ##. #. #* #$ #* # #
# #  #  #  #  #  ## #
# .  $  *        .  #
# ##$ #. #$ #* #* # #
# ## ## ## ## ## ## #
#                   #
#####################

; 1014_cjcjc-2x2-10x10_24
########################
#@                     #
# ##.##$##$##*##$##*## #
# #  #  #  #  #  #  ## #
# *  $  .  *  .     .  #
# ##* #* #  #$ #  #* # #
# #  #  #  #  #  #  ## #
# $  *  $  .  *  *  .  #
# ##. #. #* #  #$ #$ # #
# #  #  #  #  #  #  ## #
#    .  $  .     .  $  #
# ##* #$ #$ #* #. #. # #
# #  #  #  #  #  #  ## #
# *  .  *     .  $     #
# ##  #$ #* #* #$ #* # #
# #  #  #  #  #  #  ## #
# *  $  *     .  $  *  #
# ##. #  #$ #$ #. #. # #
# #  #  #  #  #  #  ## #
# *  *  .  *     .  $  #
# ##  #  #* #$ #* #. # #
# ## ## ## ## ## ## ## #
#                      #
########################

