; 1001_4_boxes_1
   ######
 ###   @#
## $$ # #
# ....  #
# #$$  ##
#   #### 
#####    

; 1001_4_boxes_2
########
#.. #  #
# $  $ #
## ##  #
#  ## ##
# .* $@#
#  #   #
########

