; 0117_richard_weston_collection_1
#################
#+  #   #       #
#     $ # $ $ $ #
# $ #     # # # #
### # ## .......#
### #     # # # #
#.  ### ## $  $ #
#.     $ # $  $ #
#.$ ##   #      #
#################

; 0117_richard_weston_collection_2
     ######  
######    #  
#   .#    #  
# $$ #    #  
#  # #### ###
##.    $ $ .#
 #######   .#
       ## ###
       #   .#
       # $$ #
       #  # #
       ##. @#
        #####

; 0117_richard_weston_collection_3
   #  #      # # ##   
  # ## ### ## # #  #  
 #       .#@     #  # 
 #  # #     #     # # 
#  #   #  # #    #   #
 #  #        #      # 
 #  # # ###      #  # 
#  #       # # ##    #
 #  # $          #  # 
  #  ##   ###   #  #  
   #   # #   # #  #   
    ##  #  #  #  #    
      #    #    #     
       ## # # ##      
         #   #        

; 0117_richard_weston_collection_4
#########
#.  @  .#
# $###$ #
#. ###..#
#$$ $ $ #
#   .   #
#########

; 0117_richard_weston_collection_5
    #########
#####       #
##  $ $ $   #
# #     #   #
#  #...#    #
# $ ### $   #
# $..+.. $  #
#   ###   $# 
#  #...#$  # 
# #    $  $# 
##         # 
############ 

; 0117_richard_weston_collection_6
###################
#   .  .  .  .  . #
#  ##### ######## #
#               $ #
## ########## #####
#         #      @#
#  $   #     #### #
### #### #####    #
#  $   # #  $   $ #
#                 #
######## ##########
     #   #         
     #   #         
     #   #         
     #####         

; 0117_richard_weston_collection_7
  ########      ## 
 #    @   ######  #
 #$#####       $  #
 # #       #####  #
 # #$######....#$ #
 # # #      ..    #
#    #      .. # # 
# #  ########### # 
# #              # 
# ####### ###### # 
#  $    $        # 
#   $  $         # 
 ########        # 
         ########  

; 0117_richard_weston_collection_8
 ############## 
##   #   #   # #
#  $ $ $ $ $ $ #
#  #        #  #
#$ $ $ $ $ $ $ #
#  #        #  #
#  # $ $ $ $ $ #
#  #        #  #
#...##   $ $ $ #
#....###       #
#.......#### $ #
#+.......     ##
 ############## 

; 0117_richard_weston_collection_9
######   
#    ####
#.$.  $+#
#  $#####
#$  #    
#  $#####
#.$.   .#
#    ####
######   

; 0117_richard_weston_collection_10
    ####    
    #  #    
    #  #    
    #$+#    
####  $ ####
#  .$.. $  #
#  $ ..$.  #
#### $  ####
    #.$#    
    #  #    
    #  #    
    #  #    
    ####    

