; 0304_red_mini_1
########
#@ # . #
# **.  #
# $ .* #
##$$  ##
 #    # 
 ###### 

; 0304_red_mini_2
####    
#  #### 
#@*   ##
# $.*$.#
#    # #
##$ ## #
 #    .#
 #######

; 0304_red_mini_3
  ######
###    #
#@$ ## #
#  $.* #
# #$ .##
#.$. ## 
#    #  
######  

; 0304_red_mini_4
 ######
 #@   #
##.$  #
# .**##
#  .  #
## $$ #
 ###  #
   ####

; 0304_red_mini_5
   ##### 
####.. # 
#@ $  $##
#   #   #
#####   #
    #####

; 0304_red_mini_6
#####  
#@  ###
# **  #
# * . #
# $$  #
### . #
  #####

; 0304_red_mini_7
#####   
#@  ####
# $*. .#
# $   ##
# **# # 
###   # 
  ##### 

; 0304_red_mini_8
###### 
#.   # 
# #*$##
# * * #
# * @ #
# #   #
#   ###
#####  

; 0304_red_mini_9
#####   
#@  ####
#  *$  #
# *..  #
##$* ###
#    #  
#   ##  
#####   

; 0304_red_mini_10
#######
#@    #
#  *$ #
# *.$ #
##$. ##
 #.  # 
 ##### 

; 0304_red_mini_11
###### 
#@   # 
# $*$##
# * * #
##. . #
 #    #
 ######

; 0304_red_mini_12
###### 
#@   ##
# * * #
# .$. #
# $*  #
###   #
  #####

; 0304_red_mini_13
  ###### 
###  . ##
#@$* #  #
#. $    #
#.$* # ##
##    ## 
 ######  

; 0304_red_mini_14
 ####### 
 #    @# 
## *   # 
#   *$## 
#. $# ###
#.#     #
###     #
  #  #  #
  #######

; 0304_red_mini_15
    ####
 ####  #
 # $ $ #
##.#$@ #
# .. # #
#  . $ #
###  ###
  ####  

; 0304_red_mini_16
  ####  
###  #  
# @.$## 
# $ . ##
# *.*$ #
#  $ . #
#  #####
####    

; 0304_red_mini_17
   #### 
####  ##
# $ .* #
#@$*   #
# $ #. #
###   .#
  ######

