; 0901_pathfinder_1
##### 
# . ##
# $$ #
# @$.#
#.   #
######

; 0901_pathfinder_2
  #### 
###  ##
#     #
# *$  #
##+* ##
 ##  # 
  #### 

; 0901_pathfinder_3
#####  
#..@###
##$$  #
 #. $ #
 ##   #
  #####

; 0901_pathfinder_4
######
# $. #
#.$$.#
# $  #
#@ . #
######

; 0901_pathfinder_5
 ##### 
 #  @# 
##$# # 
#  $ # 
#.  $##
###. .#
  #####

; 0901_pathfinder_6
######
#.* .#
###  #
#  $$#
#@   #
######

; 0901_pathfinder_7
##########
# .$ #.$.#
#@$$ $   #
# .  #.  #
##########

; 0901_pathfinder_8
####   
# .#   
# $####
#  . .#
##$# ##
 # $ # 
 #  @# 
 ##### 

; 0901_pathfinder_9
#######
#   ..#
# $*$ #
#  @###
##  #  
 ####  

; 0901_pathfinder_10
#####  
#   ## 
# .$ ##
#.$ $ #
#$.$. #
#+$.  #
#######

