; 0828_sokoking_01_1
      ####   
     ##..##  
     #..*.#  
     #....###
###### $  $ #
#   $   $ # #
# $  $$ $   #
# ####   ####
# ## # #$#   
#@#  #   #   
###  #####   

; 0828_sokoking_01_2
########
#      #
# $#$#$#
# $  ..#
# $$*.+#
#   ..##
########

; 0828_sokoking_01_3
##########
#      ..#
#  $ $#..#
# $$$  ..#
# $@$ $..#
# $ $ $..#
# $$$  ..#
#  $ $#..#
#      ..#
##########

; 0828_sokoking_01_4
#######
# . . #
#.$$$.#
# $@$ #
#.$$$.#
# . . #
#######

; 0828_sokoking_01_5
##########
##       #
#  $$$$$ #
# $#...$ #
#  #.$.$ #
####.$$$ #
#....@   #
####.#####
#  #.#   #
##########

; 0828_sokoking_01_6
##########
# *.....##
# #....###
# #.*..  #
# #$$$$# #
# #    # #
# # $### #
# #    $ #
# # $#$# #
# #  # $ #
# # $$ # #
# #    # #
# # #$## #
#@#      #
##########

; 0828_sokoking_01_7
###############
#  #     #  #.#
# $#$#$# # $#.#
#  $ $      #.#
# $# # # #.**.#
#  # $ $ $....#
#  # # # # ##.#
#  # $ # # ##.#
#    $     ##.#
# #$#$#######.#
#       @####.#
###############

; 0828_sokoking_01_8
##############
###    #     #
# $ ## # $   #
# #  # #$#$# #
# #$ # # $   #
# $  $ # #$# #
# #.##.# .   #
# #.##.#$*$$ #
#.*......... #
# #.#$.#$*$$ #
# #.# .# .   #
# #*#$ #$$## #
# #+#  #     #
# ###$ # ##$ #
#      #     #
#####  #######
#####  #######
##############

; 0828_sokoking_01_9
############# 
#  #        # 
# $#$# ###$ # 
#     $   $ # 
# $$    ##### 
#  ##*.##   # 
# $##..##@$ # 
#  ##.*#### # 
# $##.. $ # # 
#  ##*.$  # ##
#####.*# ##  #
    #..#     #
    #..#  ####
    #######   

; 0828_sokoking_01_10
          ######
          #    #
          #    #
          #    #
          ### ##
          #    #
          #    #
          #    #
 ########## # ##
 #........     #
 #  ########   #
 ## #      # # #
  # #      #   #
  # #      #####
### ###         
#     #         
# $$$ #         
# $@$ #         
# $$$ #         
#     #         
#######         

; 0828_sokoking_01_11
  #####    
  # . #    
  # * #    
  #...#    
  #...#    
  ##.##    
   #.#     
   #.#     
   #*#     
#### ####  
#     $ #  
# ##$   #  
#   $ ###  
# $## #    
#   $ #####
####  $   #
   #    # #
  ##$# #  #
  #@ $ $ ##
  ##$# ####
   #   #   
   #####   
           

; 0828_sokoking_01_12
      #####     
      #   #     
      # #$#     
      #   #     
   #### # ####  
   #  $ $ $  #  
 ### ## # ## ###
 #             #
 # # #$$#$$# # #
 # $ $     $ $ #
 ### ## #### ###
   # $  #  $ #  
   # ##   ## #  
   #         #  
   #####.#####  
       #.#      
       #.#      
       #.#      
       #.#      
       #.#      
       #.#      
       #.#      
       #.#      
       #.#      
       #.#      
       #.#      
       #.#      
       #.#      
       #.#      
       #.#      
     ###.###    
     # $$$ #    
     #  @  #    
     #######    
                

; 0828_sokoking_01_13
           #####
           #   #
 ######### # # #
 #+     .# #   #
 # #####*# # # #
 # #   #.# # $ #
 # #   #.# # # #
## #   #.# # $ #
#  #####.### # #
# .*.....$   $ #
#  ##### ### # #
####   # $   $ #
    #### #$#$# #
    #  $ $     #
    # ## #$#$# #
    #          #
    ############
                

