; 0507_three_parallel_1
#######
#     #
# *.* #
#   $##
# *** #
##$   #
# *.* #
#  @  #
#  ####
####   

; 0507_three_parallel_2
 ####    
##  #####
#       #
# ***** #
#       #
##**.**##
#   $   #
# ***** #
#   @   #
#########

; 0507_three_parallel_3
 ####    
##  #####
#       #
# **.*# #
##      #
# **#** #
#   @   #
# #*$** #
#   #   #
#########

; 0507_three_parallel_4
 ####    
##  #####
#       #
# **.** #
##      #
# ***** #
#       #
# **$** #
### @ ###
  #####  

; 0507_three_parallel_5
  ####   
###  ####
#       #
# #***# #
# #   # #
#  *+*  #
# # $ # #
# #***# #
#       #
#########

; 0507_three_parallel_6
  #######
###     #
# . # * #
# * * * #
# * * * #
# * * * #
# * * $ #
####@ ###
   ####  

; 0507_three_parallel_7
####    
#  #####
#  #   #
# **** #
#  $   #
##.**.##
#  $   #
# **** #
#      #
### @###
  ####  

; 0507_three_parallel_8
 #####        
 #   #########
## # * * .   #
# $ $* * * # #
#  # . * *   #
#  @ #########
######        

; 0507_three_parallel_9
  #######
###     #
# ***** #
# $   $ #
# ..#.. #
# $ @ $ #
# ***** #
#     ###
####  #  
   ####  

; 0507_three_parallel_10
   ####   
####  ####
#        #
# #****# #
# *      #
# .****# #
##     $ #
# *****# #
#    @   #
##########

; 0507_three_parallel_11
########## 
#        # 
# ****** # 
# #     $# 
# .***** ##
#      #  #
# ******  #
#    @   ##
########## 

; 0507_three_parallel_12
#########
#       #
# ***** #
#      ##
# **+** #
##  $   #
# ***** #
#       #
###  ####
  ####   

; 0507_three_parallel_13
   ####  
####  ###
#       #
# ***** #
# $    ##
# .*#** #
##      #
# ***** #
#   @   #
#########

; 0507_three_parallel_14
 ####    
 #  #####
##      #
# **#** #
#   #   #
# #*#*# #
#   #   #
# .* *$ #
#   # @ #
#########

; 0507_three_parallel_15
   ####### 
   # .   # 
 ### # * ##
 # * * *  #
## * * *  #
#  * * * ##
#  * * * # 
## *$# ### 
 #   @ #   
 #######   

; 0507_three_parallel_16
    ##### 
    # @ # 
##### # # 
# * * * ##
# * . *  #
# * * *  #
# *$*#* ##
#       # 
######### 

; 0507_three_parallel_17
  #####       
  #   ########
  # $        #
  ##$######  #
  # * * *   ##
### * * . # # 
#   * . * # ##
# # . * * #  #
# @ * * *  $ #
###########  #
          ####

; 0507_three_parallel_18
#########  
#   ##  #  
# $     #  
##$#$## ## 
 # . . . # 
 #$.#.$.$# 
 # * * * # 
 #$.$.#.$# 
 # . . . # 
 ## ##$#$##
  #     $ #
  #  ## @ #
  #########

